ORIGIN,DEST,ON_TIME,DELAYED15MIN,DIVERTED,CANCELLED,TOTAL
ABE,ATL,1396,239,6,38,1679
ABE,AVP,0,0,0,1,1
ABE,CLE,26,8,0,0,34
ABE,CLT,909,115,0,26,1050
ABE,DTW,1236,311,5,34,1586
ABE,FLL,118,33,2,0,153
ABE,IAD,240,20,0,16,276
ABE,MCO,1071,145,1,7,1224
ABE,ORD,3733,903,18,217,4871
ABI,DFW,6374,848,8,185,7415
ABQ,ATL,2516,394,8,25,2943
ABQ,BWI,1450,248,6,14,1718
ABQ,DAL,6754,1305,40,50,8149
ABQ,DEN,6915,1318,14,75,8322
ABQ,DFW,7261,951,20,185,8417
ABQ,ELP,1533,312,2,4,1851
ABQ,EWR,1,1,0,0,2
ABQ,HOU,2453,517,12,8,2990
ABQ,IAD,950,123,3,18,1094
ABQ,IAH,4378,916,15,49,5358
ABQ,LAS,4865,905,8,14,5792
ABQ,LAX,7088,1416,13,67,8584
ABQ,LBB,668,278,4,3,953
ABQ,MAF,663,286,1,4,954
ABQ,MCI,1093,154,3,4,1254
ABQ,MCO,828,146,5,1,980
ABQ,MDW,1960,193,7,12,2172
ABQ,MSP,1490,193,2,13,1698
ABQ,OAK,2323,398,4,13,2738
ABQ,ORD,1775,514,12,59,2360
ABQ,PDX,825,199,1,0,1025
ABQ,PHX,12097,2064,9,119,14289
ABQ,SAN,2195,382,5,8,2590
ABQ,SEA,1679,331,2,5,2017
ABQ,SFO,1141,146,5,19,1311
ABQ,SLC,4881,461,8,29,5379
ABQ,STL,962,121,4,4,1091
ABQ,TUS,1706,370,0,2,2078
ABR,MSP,564,41,0,12,617
ABY,ATL,2432,544,3,51,3030
ACK,BOS,88,23,0,0,111
ACK,JFK,609,209,2,24,844
ACT,DFW,1617,187,0,71,1875
ACT,IAH,152,27,0,8,187
ACV,CEC,717,166,19,38,940
ACV,CIC,1,0,0,0,1
ACV,RDD,0,0,1,0,1
ACV,SFO,4161,2618,8,458,7245
ACV,SMF,1412,330,4,126,1872
ACY,ATL,1246,187,2,31,1466
ACY,MCO,101,9,0,3,113
ADK,ANC,209,85,0,18,312
ADQ,ANC,1580,239,0,193,2012
AEX,ATL,3328,675,9,78,4090
AEX,DFW,2929,478,8,78,3493
AEX,IAH,2005,402,5,49,2461
AEX,LFT,0,0,1,0,1
AEX,MEM,494,73,1,21,589
AGS,ATL,7214,2061,1,184,9460
AGS,CLT,63,14,0,1,78
AGS,DFW,954,198,5,25,1182
AGS,LGA,7,4,0,0,11
AKN,ANC,208,35,0,2,245
ALB,ATL,2059,457,7,53,2576
ALB,BWI,4729,941,15,80,5765
ALB,CLE,2755,426,2,61,3244
ALB,CLT,1845,305,2,41,2193
ALB,CVG,241,13,3,2,259
ALB,DTW,1110,277,1,48,1436
ALB,EWR,544,323,0,65,932
ALB,FLL,992,97,5,4,1098
ALB,IAD,1598,391,2,76,2067
ALB,JFK,220,82,0,19,321
ALB,LAS,953,135,3,4,1095
ALB,MCO,2191,332,6,21,2550
ALB,MDW,1872,244,9,27,2152
ALB,MSP,183,17,0,6,206
ALB,ORD,3184,742,20,114,4060
ALB,TPA,1038,70,1,7,1116
ALO,MSP,95,13,0,3,111
ALO,ORD,445,50,1,13,509
AMA,DAL,5232,844,21,93,6190
AMA,DEN,2678,529,8,34,3249
AMA,DFW,4947,1044,11,196,6198
AMA,IAH,3241,626,8,96,3971
AMA,LAS,929,161,0,6,1096
AMA,LBB,0,0,0,1,1
AMA,MEM,488,64,1,7,560
AMA,SHV,0,1,0,0,1
ANC,ADK,247,47,1,17,312
ANC,ADQ,1635,183,4,190,2012
ANC,AKN,221,22,0,2,245
ANC,ATL,55,28,0,0,83
ANC,BET,2567,369,2,95,3033
ANC,CDV,923,146,13,2,1084
ANC,DEN,872,247,2,5,1126
ANC,DFW,313,119,4,2,438
ANC,DLG,207,32,2,3,244
ANC,DTW,120,16,0,0,136
ANC,FAI,7422,787,10,36,8255
ANC,HNL,820,108,0,0,928
ANC,IAH,239,129,1,1,370
ANC,JNU,2906,399,57,6,3368
ANC,KOA,8,0,0,0,8
ANC,LAX,529,50,2,1,582
ANC,LGB,178,28,0,3,209
ANC,MSP,1868,327,7,5,2207
ANC,OGG,162,33,0,0,195
ANC,OME,958,125,23,17,1123
ANC,ORD,1256,391,12,3,1662
ANC,OTZ,1782,261,53,28,2124
ANC,PDX,2097,191,3,6,2297
ANC,PHL,110,69,0,1,180
ANC,PHX,961,213,2,13,1189
ANC,SCC,858,95,6,12,971
ANC,SEA,16072,1789,41,102,18004
ANC,SFO,259,68,2,3,332
ANC,SLC,1196,146,2,3,1347
APN,DTW,72,8,0,2,82
APN,MSP,108,6,0,4,118
ART,ORD,595,79,2,26,702
ASE,ATL,54,24,2,7,87
ASE,DEN,7277,1352,6,666,9301
ASE,DFW,137,45,0,21,203
ASE,IAH,315,93,1,22,431
ASE,LAX,1202,347,1,98,1648
ASE,ORD,869,333,6,102,1310
ASE,SFO,289,165,3,39,496
ASE,SLC,69,24,0,8,101
ATL,ABE,1440,431,7,27,1905
ATL,ABQ,2378,547,2,14,2941
ATL,ABY,2451,532,6,41,3030
ATL,ACY,1201,232,3,29,1465
ATL,AEX,3246,774,10,58,4088
ATL,AGS,7387,1877,20,167,9451
ATL,ALB,1963,551,10,46,2570
ATL,ANC,57,26,0,0,83
ATL,ASE,51,23,6,7,87
ATL,ATW,913,374,7,32,1326
ATL,AUS,5733,1048,5,57,6843
ATL,AVL,7095,1723,19,176,9013
ATL,AVP,305,68,0,3,376
ATL,BDL,5350,852,11,96,6309
ATL,BHM,9080,2119,12,183,11394
ATL,BKG,1690,182,8,24,1904
ATL,BMI,4943,1314,26,114,6397
ATL,BNA,8147,1864,12,147,10170
ATL,BOS,13223,3170,20,242,16655
ATL,BQK,2345,534,13,51,2943
ATL,BTR,6506,1845,24,126,8501
ATL,BUF,7365,1078,25,81,8549
ATL,BWI,15755,3339,28,328,19450
ATL,BZN,139,34,3,1,177
ATL,CAE,8164,1991,8,132,10295
ATL,CAK,7764,1628,20,93,9505
ATL,CHA,7369,1805,6,161,9341
ATL,CHO,2523,496,12,64,3095
ATL,CHS,8988,1765,16,172,10941
ATL,CID,671,125,3,6,805
ATL,CLE,6065,1577,12,158,7812
ATL,CLT,17733,3795,19,262,21809
ATL,CMH,8325,1486,13,101,9925
ATL,COS,922,227,8,8,1165
ATL,COU,258,50,2,0,310
ATL,CRW,3924,961,40,108,5033
ATL,CSG,3351,858,1,78,4288
ATL,CVG,6205,1102,7,55,7369
ATL,DAB,4171,910,18,55,5154
ATL,DAL,427,88,2,0,517
ATL,DAY,7592,1389,12,109,9102
ATL,DCA,17986,3808,55,569,22418
ATL,DEN,13892,2685,41,101,16719
ATL,DFW,22206,3954,101,529,26790
ATL,DHN,3244,729,7,75,4055
ATL,DSM,1912,571,5,29,2517
ATL,DTW,12116,2463,23,92,14694
ATL,ECP,5727,1314,21,104,7166
ATL,EGE,266,33,6,5,310
ATL,ELP,1952,404,13,17,2386
ATL,EVV,2741,606,11,54,3412
ATL,EWN,2201,527,12,38,2778
ATL,EWR,11114,4196,67,670,16047
ATL,EYW,2733,654,33,85,3505
ATL,FAY,7086,1843,24,144,9097
ATL,FCA,29,1,0,0,30
ATL,FLL,18386,4031,26,144,22587
ATL,FLO,229,46,1,8,284
ATL,FNT,5786,1359,8,95,7248
ATL,FSD,92,32,0,0,124
ATL,FSM,358,53,3,1,415
ATL,FWA,1160,264,5,21,1450
ATL,GNV,5623,1374,13,85,7095
ATL,GPT,5326,1176,29,111,6642
ATL,GRK,1443,553,7,30,2033
ATL,GRR,2105,686,11,52,2854
ATL,GSO,6810,1683,9,143,8645
ATL,GSP,6487,1519,8,151,8165
ATL,GTR,1729,371,3,29,2132
ATL,GUC,12,1,0,0,13
ATL,HDN,266,28,6,3,303
ATL,HNL,897,195,1,3,1096
ATL,HOU,8612,1906,31,133,10682
ATL,HPN,5306,1798,57,188,7349
ATL,HSV,7589,1732,13,168,9502
ATL,IAD,11239,2239,27,343,13848
ATL,IAH,11955,2988,40,217,15200
ATL,ICT,5680,1336,16,85,7117
ATL,ILM,5248,1273,13,101,6635
ATL,IND,9527,1936,13,125,11601
ATL,JAC,141,22,4,2,169
ATL,JAN,6542,1630,16,130,8318
ATL,JAX,13793,2716,6,165,16680
ATL,JFK,5042,1475,12,87,6616
ATL,LAS,10750,1913,30,51,12744
ATL,LAX,12067,3107,23,48,15245
ATL,LEX,6174,1541,13,114,7842
ATL,LFT,3211,815,21,57,4104
ATL,LGA,22949,7188,174,1101,31412
ATL,LIT,6492,1539,24,133,8188
ATL,LWB,525,122,1,14,662
ATL,LYH,748,170,4,21,943
ATL,MCI,9415,1606,31,142,11194
ATL,MCO,22488,4858,24,147,27517
ATL,MDT,3658,1033,18,76,4785
ATL,MDW,12254,2465,43,241,15003
ATL,MEI,1493,354,6,41,1894
ATL,MEM,11268,2335,17,152,13772
ATL,MFE,491,149,4,6,650
ATL,MGM,6826,1595,15,134,8570
ATL,MHT,1179,249,3,10,1441
ATL,MIA,14954,3076,44,249,18323
ATL,MKE,9586,1804,30,112,11532
ATL,MLB,3850,919,5,49,4823
ATL,MLI,3723,1170,13,84,4990
ATL,MLU,2801,702,11,60,3574
ATL,MOB,6442,1675,19,145,8281
ATL,MSN,1035,264,4,23,1326
ATL,MSP,13781,2672,28,121,16602
ATL,MSY,13202,2322,20,208,15752
ATL,MTJ,150,30,0,1,181
ATL,MYR,4741,1093,10,94,5938
ATL,OAJ,3627,896,21,68,4612
ATL,OAK,66,37,0,0,103
ATL,OKC,3416,1000,10,65,4491
ATL,OMA,3053,909,15,60,4037
ATL,ONT,961,229,2,5,1197
ATL,ORD,17150,4934,49,608,22741
ATL,ORF,6457,1060,13,109,7639
ATL,PBI,10256,2239,27,102,12624
ATL,PDX,2667,569,9,12,3257
ATL,PFN,937,166,8,32,1143
ATL,PHF,7292,1579,23,163,9057
ATL,PHL,16053,3843,29,425,20350
ATL,PHX,10265,1752,25,56,12098
ATL,PIA,523,110,0,4,637
ATL,PIT,10389,1892,20,155,12456
ATL,PNS,9504,1853,25,126,11508
ATL,PVD,2596,550,9,46,3201
ATL,PWM,2065,500,17,33,2615
ATL,RDU,13801,2115,18,182,16116
ATL,RIC,10654,1517,15,192,12378
ATL,RNO,0,2,0,0,2
ATL,ROA,3822,1010,31,96,4959
ATL,ROC,5506,1076,17,58,6657
ATL,RSW,10290,1965,19,82,12356
ATL,SAN,4806,956,26,29,5817
ATL,SAT,9523,1899,20,98,11540
ATL,SAV,8618,1906,13,142,10679
ATL,SBN,1369,324,7,19,1719
ATL,SCE,1,0,0,0,1
ATL,SDF,6378,1382,10,134,7904
ATL,SEA,6772,1594,12,28,8406
ATL,SFO,7422,2256,16,31,9725
ATL,SGF,3158,728,19,44,3949
ATL,SHV,4205,1009,13,85,5312
ATL,SJC,766,213,3,8,990
ATL,SJU,5843,932,16,25,6816
ATL,SLC,7109,1361,9,44,8523
ATL,SMF,1634,286,5,10,1935
ATL,SNA,4193,585,12,36,4826
ATL,SRQ,7202,1215,10,63,8490
ATL,STL,10026,1724,19,148,11917
ATL,STT,1568,170,10,8,1756
ATL,STX,103,24,0,0,127
ATL,SWF,913,453,2,35,1403
ATL,SYR,2327,669,7,31,3034
ATL,TLH,7386,1852,18,148,9404
ATL,TPA,17671,3454,21,156,21302
ATL,TRI,6378,1334,13,116,7841
ATL,TUL,2963,985,15,71,4034
ATL,TUS,1757,361,5,10,2133
ATL,TYS,6466,1512,6,129,8113
ATL,UTM,185,18,1,4,208
ATL,VLD,2444,619,11,45,3119
ATL,VPS,8009,2257,18,155,10439
ATL,XNA,4534,1079,25,103,5741
ATW,ATL,1100,187,1,37,1325
ATW,DEN,265,37,0,7,309
ATW,DTW,1315,321,2,53,1691
ATW,MEM,2,1,0,0,3
ATW,MSN,0,1,0,0,1
ATW,MSP,1986,219,0,41,2246
ATW,ORD,4355,1037,3,302,5697
AUS,ATL,5763,996,14,68,6841
AUS,BKG,94,11,0,1,106
AUS,BNA,1766,268,3,3,2040
AUS,BOS,772,297,3,24,1096
AUS,BWI,2022,370,6,22,2420
AUS,CLT,2738,252,3,19,3012
AUS,CVG,19,2,0,0,21
AUS,DAL,10176,1543,31,80,11830
AUS,DCA,145,28,2,2,177
AUS,DEN,6298,1068,21,30,7417
AUS,DFW,14002,1681,15,303,16001
AUS,DTW,463,84,0,7,554
AUS,ELP,2989,599,4,10,3602
AUS,EWR,2050,617,10,52,2729
AUS,FLL,1814,362,9,5,2190
AUS,HOU,4457,838,10,13,5318
AUS,HRL,911,160,2,9,1082
AUS,IAD,1316,316,9,28,1669
AUS,IAH,8751,1456,4,75,10286
AUS,JFK,3010,550,15,89,3664
AUS,LAS,2766,494,3,2,3265
AUS,LAX,5300,906,5,39,6250
AUS,LBB,1580,303,5,8,1896
AUS,LGB,865,221,0,3,1089
AUS,MCO,2294,403,7,6,2710
AUS,MDW,1816,316,7,11,2150
AUS,MEM,872,144,2,22,1040
AUS,MSP,478,135,2,2,617
AUS,OAK,854,207,0,1,1062
AUS,ORD,4762,936,22,97,5817
AUS,PDX,54,15,0,0,69
AUS,PHL,146,24,0,10,180
AUS,PHX,7428,992,11,40,8471
AUS,SAN,1789,281,9,4,2083
AUS,SEA,845,230,0,4,1079
AUS,SFO,2998,866,13,31,3908
AUS,SJC,1892,318,1,5,2216
AUS,SLC,1381,227,3,7,1618
AUS,TPA,873,212,5,2,1092
AVL,ABE,0,0,1,0,1
AVL,ATL,7005,1807,7,187,9006
AVL,CLT,0,1,0,0,1
AVL,CMX,0,1,0,0,1
AVL,DFW,257,24,1,1,283
AVL,DTW,744,173,5,21,943
AVL,EWR,812,307,4,88,1211
AVL,GSP,0,0,1,0,1
AVL,IAH,642,276,2,19,939
AVL,LGA,26,14,0,2,42
AVL,MCO,312,54,0,4,370
AVL,ORD,1765,425,10,50,2250
AVL,TPA,148,26,1,0,175
AVP,ATL,339,50,0,4,393
AVP,CLT,322,12,3,11,348
AVP,DTW,877,199,4,37,1117
AVP,JFK,0,1,0,0,1
AVP,ORD,2330,678,12,116,3136
AZA,DEN,41,6,0,0,47
AZO,DTW,1425,248,2,71,1746
AZO,MSP,342,41,0,18,401
AZO,ORD,2088,278,0,137,2503
BDL,ATL,5378,806,18,109,6311
BDL,BNA,609,55,1,5,670
BDL,BOS,0,1,0,0,1
BDL,BWI,6407,1431,23,134,7995
BDL,CLE,853,82,1,10,946
BDL,CLT,4357,791,12,111,5271
BDL,CVG,696,91,1,21,809
BDL,DCA,1230,140,1,52,1423
BDL,DEN,904,110,1,9,1024
BDL,DFW,2688,415,20,58,3181
BDL,DTW,3260,454,7,69,3790
BDL,EWR,915,265,0,57,1237
BDL,FLL,2172,397,4,46,2619
BDL,IAD,3193,548,3,121,3865
BDL,JFK,224,100,0,21,345
BDL,LAS,828,161,7,7,1003
BDL,LAX,40,37,0,0,77
BDL,MCO,4987,862,9,72,5930
BDL,MDW,2426,397,11,39,2873
BDL,MIA,1119,149,6,26,1300
BDL,MSP,1597,210,5,29,1841
BDL,ORD,7078,1555,30,284,8947
BDL,PBI,644,148,3,11,806
BDL,PHL,802,185,4,22,1013
BDL,PVD,0,0,1,0,1
BDL,RDU,406,55,1,20,482
BDL,RSW,274,47,0,6,327
BDL,SJU,990,178,3,14,1185
BDL,TPA,1974,236,1,22,2233
BET,ANC,2475,454,4,100,3033
BFL,DEN,1128,108,2,17,1255
BFL,FAT,0,0,1,0,1
BFL,IAH,1016,140,2,7,1165
BFL,LAX,1647,441,0,29,2117
BFL,PHX,2920,284,2,36,3242
BFL,SBA,0,1,0,0,1
BFL,SBP,0,0,2,0,2
BFL,SFO,2159,881,10,118,3168
BGM,DTW,764,136,3,28,931
BGM,ORD,0,1,0,0,1
BGR,DTW,1439,346,5,35,1825
BGR,JFK,143,32,0,14,189
BGR,LGA,179,27,0,7,213
BHM,ATL,9077,2094,4,222,11397
BHM,BNA,1682,300,2,6,1990
BHM,BTR,1,0,0,0,1
BHM,BWI,2475,490,12,41,3018
BHM,CLT,1404,172,2,21,1599
BHM,COU,1,0,0,0,1
BHM,DAL,2612,429,9,18,3068
BHM,DEN,1098,183,11,7,1299
BHM,DFW,2748,372,10,70,3200
BHM,DTW,1198,237,4,25,1464
BHM,HOU,1766,280,4,13,2063
BHM,HSV,1,0,0,0,1
BHM,IAH,4804,1180,18,79,6081
BHM,JAX,825,258,1,2,1086
BHM,LAS,925,171,0,0,1096
BHM,LAX,1,0,0,0,1
BHM,LGA,471,109,5,36,621
BHM,MCO,1879,299,2,9,2189
BHM,MDW,1770,318,7,15,2110
BHM,MEM,1753,227,3,26,2009
BHM,MIA,1642,284,13,34,1973
BHM,MSP,190,32,1,8,231
BHM,MSY,1663,302,4,10,1979
BHM,ORD,2298,590,14,73,2975
BHM,PHX,827,99,3,4,933
BHM,SDF,988,220,1,2,1211
BHM,STL,945,146,1,4,1096
BHM,TPA,1736,359,2,3,2100
BIL,BZN,0,0,1,0,1
BIL,CLE,1,0,0,1,2
BIL,COD,0,0,2,0,2
BIL,DEN,4003,682,8,77,4770
BIL,MSP,910,97,2,7,1016
BIL,ORD,275,44,0,3,322
BIL,SLC,4397,250,6,27,4680
BIS,CLE,0,1,0,0,1
BIS,DEN,3214,617,12,78,3921
BIS,FAR,0,1,0,0,1
BIS,MLI,0,1,0,0,1
BIS,MOT,0,0,1,0,1
BIS,MSP,4279,590,7,92,4968
BIS,ORD,634,178,3,34,849
BIS,RAP,0,0,1,0,1
BIS,SLC,286,76,2,4,368
BJI,MSP,613,43,0,14,670
BKG,ATL,1631,236,7,30,1904
BKG,AUS,76,29,0,1,106
BKG,BNA,33,17,0,2,52
BKG,BWI,50,5,0,2,57
BKG,DEN,438,101,2,5,546
BKG,DSM,80,27,0,1,108
BKG,GPT,42,5,0,0,47
BKG,HOU,376,63,0,5,444
BKG,IND,24,4,0,2,30
BKG,MCO,140,14,0,3,157
BKG,MDW,327,27,2,5,361
BKG,PHX,7,1,0,0,8
BKG,SHV,41,3,0,1,45
BLI,DEN,95,21,0,0,116
BLI,HNL,559,78,5,0,642
BLI,LAS,910,95,0,2,1007
BLI,OGG,29,1,0,0,30
BMI,ATL,5218,1031,14,136,6399
BMI,DFW,907,163,10,16,1096
BMI,DTW,633,143,2,12,790
BMI,MCO,445,93,0,1,539
BMI,MSP,387,61,0,12,460
BMI,ORD,834,165,0,70,1069
BMI,RSW,39,3,0,1,43
BNA,ATL,7885,2187,16,171,10259
BNA,AUS,1684,371,0,5,2060
BNA,BDL,495,165,2,8,670
BNA,BHM,1602,384,6,5,1997
BNA,BKG,33,17,0,2,52
BNA,BOS,109,32,0,1,142
BNA,BWI,5402,1278,18,94,6792
BNA,CHS,568,91,1,0,660
BNA,CLE,1693,403,2,10,2108
BNA,CLT,4925,726,5,66,5722
BNA,CMH,1622,424,2,7,2055
BNA,CVG,1352,220,3,27,1602
BNA,DCA,4051,782,13,251,5097
BNA,DEN,6675,1221,34,30,7960
BNA,DFW,7080,938,29,157,8204
BNA,DTW,5131,1005,12,110,6258
BNA,ECP,1478,411,7,6,1902
BNA,EWR,3369,1532,17,205,5123
BNA,FLL,1827,387,2,4,2220
BNA,GSP,548,110,0,2,660
BNA,HOU,3333,798,8,23,4162
BNA,HSV,0,2,0,0,2
BNA,IAD,1542,343,6,43,1934
BNA,IAH,4792,1334,14,55,6195
BNA,JAX,3015,649,4,6,3674
BNA,JFK,940,210,8,50,1208
BNA,LAS,2505,364,3,1,2873
BNA,LAX,2779,609,5,18,3411
BNA,LGA,4165,891,24,208,5288
BNA,MCI,3017,523,7,12,3559
BNA,MCO,4115,805,6,22,4948
BNA,MDW,6138,1322,23,58,7541
BNA,MEM,2132,317,2,50,2501
BNA,MIA,2538,585,6,37,3166
BNA,MSP,2378,515,14,58,2965
BNA,MSY,2434,512,4,12,2962
BNA,OAK,137,31,0,0,168
BNA,ONT,43,19,0,1,63
BNA,ORD,9575,2449,26,356,12406
BNA,ORF,807,273,2,9,1091
BNA,PAH,0,1,0,0,1
BNA,PHL,1675,406,7,22,2110
BNA,PHX,2114,410,7,4,2535
BNA,PVD,343,97,2,4,446
BNA,RDU,3364,700,9,9,4082
BNA,RSW,146,24,0,0,170
BNA,SAN,1185,200,2,0,1387
BNA,SAT,1655,341,5,2,2003
BNA,SBN,1,0,0,0,1
BNA,SEA,426,63,0,0,489
BNA,SLC,912,158,6,14,1090
BNA,STL,1591,334,4,11,1940
BNA,TPA,3529,717,4,14,4264
BOI,DEN,6699,1094,20,48,7861
BOI,GEG,2196,295,8,7,2506
BOI,LAS,1943,230,1,1,2175
BOI,LAX,1988,435,2,17,2442
BOI,MSP,723,36,0,4,763
BOI,OAK,1808,236,2,4,2050
BOI,ORD,1208,216,4,11,1439
BOI,PDX,1787,238,1,6,2032
BOI,PHX,2651,242,1,9,2903
BOI,RDM,0,0,1,0,1
BOI,RNO,1352,189,2,2,1545
BOI,SEA,1187,200,3,2,1392
BOI,SFO,3420,1151,9,91,4671
BOI,SLC,6366,639,3,53,7061
BOS,ACK,83,28,0,0,111
BOS,ATL,13495,2785,37,272,16589
BOS,AUS,876,203,3,14,1096
BOS,BNA,122,19,0,1,142
BOS,BUF,2509,711,8,40,3268
BOS,BWI,15646,3478,27,452,19603
BOS,CAK,1120,322,0,20,1462
BOS,CLE,2016,401,2,52,2471
BOS,CLT,9629,2148,15,175,11967
BOS,CMH,166,53,0,4,223
BOS,COS,1,0,0,0,1
BOS,CVG,1391,307,3,33,1734
BOS,DCA,21078,3525,44,854,25501
BOS,DEN,6439,1382,27,75,7923
BOS,DFW,7198,1613,61,307,9179
BOS,DTW,5248,1071,7,120,6446
BOS,EWR,7911,3248,9,285,11453
BOS,FLL,4223,1387,10,78,5698
BOS,IAD,8395,1973,16,233,10617
BOS,IAH,3943,1131,12,47,5133
BOS,IND,840,314,4,48,1206
BOS,JAX,1181,319,3,16,1519
BOS,JFK,11476,3313,19,538,15346
BOS,LAS,1739,597,4,20,2360
BOS,LAX,6516,1707,43,94,8360
BOS,LGA,22172,4003,18,2037,28230
BOS,LGB,738,283,18,7,1046
BOS,MCI,106,57,1,0,164
BOS,MCO,8018,2182,13,113,10326
BOS,MDW,4169,903,18,92,5182
BOS,MEM,560,134,1,18,713
BOS,MIA,6049,1135,33,134,7351
BOS,MKE,3065,524,7,57,3653
BOS,MSP,4244,923,10,80,5257
BOS,MSY,818,181,2,14,1015
BOS,OAK,234,129,6,2,371
BOS,ORD,15511,3549,43,493,19596
BOS,ORF,2,0,0,1,3
BOS,PBI,2990,1053,4,50,4097
BOS,PDX,1122,193,2,8,1325
BOS,PHF,933,219,0,16,1168
BOS,PHL,14900,2998,39,648,18585
BOS,PHX,4080,840,10,61,4991
BOS,PIT,2199,462,2,42,2705
BOS,RDU,5258,1215,8,143,6624
BOS,RIC,1608,441,5,33,2087
BOS,RSW,3962,968,11,55,4996
BOS,SAN,1167,355,22,17,1561
BOS,SEA,2416,575,2,23,3016
BOS,SFO,7585,2209,134,121,10049
BOS,SJC,541,184,20,7,752
BOS,SJU,2566,861,8,40,3475
BOS,SLC,1119,350,4,16,1489
BOS,SRQ,430,124,3,10,567
BOS,STL,2036,363,4,30,2433
BOS,STT,313,79,1,4,397
BOS,TPA,2853,921,7,40,3821
BPT,IAH,13,3,0,0,16
BQK,ATL,2316,567,2,58,2943
BQN,EWR,777,165,2,12,956
BQN,JFK,1735,291,3,44,2073
BQN,MCO,1206,266,0,6,1478
BRD,INL,7,2,0,0,9
BRD,MSP,138,12,0,3,153
BRO,DFW,1834,317,7,60,2218
BRO,IAH,4310,601,11,82,5004
BRW,ANC,1107,243,6,39,1395
BRW,FAI,772,283,5,25,1085
BTM,SLC,1990,138,1,76,2205
BTR,ATL,6359,1911,22,210,8502
BTR,BHM,1,0,0,0,1
BTR,DCA,0,1,0,0,1
BTR,DFW,6765,1360,20,255,8400
BTR,IAH,5190,1011,19,105,6325
BTR,MEM,1698,356,3,39,2096
BTR,MOB,0,1,0,0,1
BTV,ALB,1,0,0,0,1
BTV,CLE,786,237,2,24,1049
BTV,DTW,657,319,4,45,1025
BTV,EWR,1491,683,1,142,2317
BTV,IAD,1307,259,6,57,1629
BTV,JFK,4138,1002,3,183,5326
BTV,LGA,3,1,0,1,5
BTV,MCO,884,109,1,7,1001
BTV,ORD,1765,512,8,103,2388
BUF,ATL,7375,1054,21,99,8549
BUF,BOS,2530,685,5,48,3268
BUF,BWI,5329,1134,16,85,6564
BUF,CLE,442,37,0,5,484
BUF,CLT,3567,551,1,49,4168
BUF,CVG,216,43,1,8,268
BUF,DTW,1277,358,1,38,1674
BUF,EWR,1126,488,2,108,1724
BUF,FLL,1749,266,4,10,2029
BUF,IAD,2965,561,7,119,3652
BUF,JFK,7578,1800,9,281,9668
BUF,LAS,1635,243,7,1,1886
BUF,LGA,245,67,2,11,325
BUF,MCO,4865,862,14,19,5760
BUF,MDW,3194,635,9,29,3867
BUF,MSP,57,11,1,1,70
BUF,ORD,7693,1843,16,243,9795
BUF,PHL,1281,218,0,32,1531
BUF,PHX,923,163,3,3,1092
BUF,RSW,552,62,1,4,619
BUF,TPA,1617,269,6,7,1899
BUR,BOI,0,1,0,0,1
BUR,DEN,3051,588,11,40,3690
BUR,DFW,2304,341,96,36,2777
BUR,JFK,1887,392,93,38,2410
BUR,LAS,11198,1564,3,142,12907
BUR,LGB,2,0,0,0,2
BUR,OAK,11736,1626,2,361,13725
BUR,PDX,1611,150,4,21,1786
BUR,PHX,11307,1227,6,135,12675
BUR,ROC,1,0,0,0,1
BUR,SEA,2999,188,2,7,3196
BUR,SFO,3954,1720,5,282,5961
BUR,SJC,7159,930,7,254,8350
BUR,SLC,2972,195,4,8,3179
BUR,SMF,7231,893,0,122,8246
BWI,ABQ,1344,362,2,14,1722
BWI,ALB,4289,1385,2,87,5763
BWI,ATL,15978,3047,41,384,19450
BWI,AUS,1827,535,5,29,2396
BWI,BDL,5920,1901,5,138,7964
BWI,BHM,2327,651,7,42,3027
BWI,BKG,53,3,1,0,57
BWI,BNA,5292,1406,8,110,6816
BWI,BOS,15269,3850,6,469,19594
BWI,BUF,4827,1661,4,89,6581
BWI,CHS,1567,382,5,16,1970
BWI,CLE,4079,1164,5,82,5330
BWI,CLT,9532,1912,7,194,11645
BWI,CMH,3724,1103,8,69,4904
BWI,CVG,497,95,2,22,616
BWI,DAY,2643,366,2,41,3052
BWI,DEN,6224,1193,26,97,7540
BWI,DFW,5186,1067,39,169,6461
BWI,DTW,7939,1632,11,167,9749
BWI,ECP,1469,348,7,19,1843
BWI,EWR,2849,1177,3,230,4259
BWI,FLL,6781,1526,16,100,8423
BWI,GRR,1922,285,7,22,2236
BWI,GSP,1014,290,0,10,1314
BWI,HOU,2623,756,6,46,3431
BWI,HSV,1389,201,4,14,1608
BWI,IAH,3272,672,11,51,4006
BWI,IND,3243,808,4,65,4120
BWI,ISP,4088,1442,4,128,5662
BWI,JAN,1196,265,6,23,1490
BWI,JAX,3341,848,9,45,4243
BWI,JFK,932,355,2,98,1387
BWI,LAS,2956,646,4,38,3644
BWI,LAX,2750,642,4,29,3425
BWI,LGA,1992,1158,5,76,3231
BWI,LIT,848,235,4,9,1096
BWI,MCI,2266,606,8,35,2915
BWI,MCO,10870,2278,23,172,13343
BWI,MDW,5591,1255,17,160,7023
BWI,MEM,875,223,2,36,1136
BWI,MHT,6382,1886,3,139,8410
BWI,MIA,2848,543,13,60,3464
BWI,MKE,3810,786,7,72,4675
BWI,MSP,2535,505,6,67,3113
BWI,MSY,2561,579,5,28,3173
BWI,OKC,797,281,4,14,1096
BWI,ORD,7718,1812,23,336,9889
BWI,ORF,3311,1112,8,59,4490
BWI,PBI,2583,811,6,41,3441
BWI,PHL,1462,529,2,46,2039
BWI,PHX,4560,1002,21,70,5653
BWI,PIT,2364,916,3,47,3330
BWI,PVD,7075,2084,13,168,9340
BWI,PWM,2470,345,1,47,2863
BWI,RDU,5404,1524,6,98,7032
BWI,ROC,2283,360,0,32,2675
BWI,RSW,3026,720,9,41,3796
BWI,SAN,1631,481,9,20,2141
BWI,SAT,2141,544,9,30,2724
BWI,SDF,2938,794,1,52,3785
BWI,SEA,741,176,1,3,921
BWI,SFO,1126,247,8,23,1404
BWI,SJU,1658,261,5,19,1943
BWI,SLC,2570,476,3,31,3080
BWI,SRQ,529,76,1,7,613
BWI,STL,3875,980,15,74,4944
BWI,TPA,7125,1675,17,111,8928
BWI,TUS,56,2,0,0,58
BZN,ATL,123,52,0,2,177
BZN,BIL,0,0,1,1,2
BZN,BTM,0,0,0,1,1
BZN,DEN,3320,599,12,45,3976
BZN,DTW,14,3,0,0,17
BZN,EWR,1,14,0,0,15
BZN,LAX,197,68,1,3,269
BZN,MSO,1,1,0,1,3
BZN,MSP,1206,133,4,11,1354
BZN,ORD,603,165,5,6,779
BZN,SFO,488,232,0,11,731
BZN,SLC,4379,333,8,19,4739
CAE,ATL,8177,1945,2,156,10280
CAE,DFW,2654,478,24,50,3206
CAE,DTW,550,141,2,7,700
CAE,EWR,24,4,0,3,31
CAE,IAD,2827,744,14,113,3698
CAE,IAH,1189,331,4,25,1549
CAE,LGA,70,33,1,6,110
CAE,ORD,2216,753,18,132,3119
CAK,ATL,7800,1561,30,125,9516
CAK,BOS,1139,303,4,16,1462
CAK,DEN,1693,362,0,12,2067
CAK,DTW,740,248,0,29,1017
CAK,FLL,47,7,1,0,55
CAK,LGA,2113,573,8,55,2749
CAK,MCO,1589,282,1,6,1878
CAK,MDW,229,50,2,3,284
CAK,MKE,1510,317,3,48,1878
CAK,ORD,2333,513,9,113,2968
CAK,RSW,430,63,3,3,499
CAK,TPA,987,123,3,6,1119
CDC,SLC,1712,206,1,22,1941
CDV,ANC,914,139,0,32,1085
CDV,YAK,932,123,13,16,1084
CEC,ACV,571,311,16,40,938
CEC,FAT,1,0,0,0,1
CEC,SFO,1149,792,3,146,2090
CEC,SMF,5,0,0,0,5
CHA,ATL,7398,1767,3,193,9361
CHA,DFW,1112,268,11,30,1421
CHA,DTW,540,151,2,5,698
CHA,MEM,592,103,2,18,715
CHA,ORD,1523,348,5,58,1934
CHO,ATL,2585,424,8,80,3097
CHO,DTW,211,29,3,11,254
CHO,ORD,952,149,7,29,1137
CHS,ATL,8999,1744,8,190,10941
CHS,BNA,592,66,1,1,660
CHS,BWI,1649,296,10,14,1969
CHS,CLT,4153,625,3,75,4856
CHS,DFW,2523,597,32,54,3206
CHS,DTW,548,155,3,14,720
CHS,EWR,2057,1070,17,209,3353
CHS,HOU,560,92,8,0,660
CHS,IAD,2654,521,5,106,3286
CHS,IAH,2014,498,15,26,2553
CHS,LGA,355,113,3,46,517
CHS,MDW,1158,146,4,4,1312
CHS,MEM,32,7,0,2,41
CHS,MIA,1450,228,4,25,1707
CHS,ORD,2601,672,20,98,3391
CHS,TYS,0,1,0,0,1
CIC,RDD,1,0,0,0,1
CIC,SFO,2842,1034,4,205,4085
CIC,SMF,0,1,0,0,1
CID,ATL,691,101,1,12,805
CID,DEN,2038,462,5,57,2562
CID,DFW,4537,877,30,148,5592
CID,DTW,990,182,3,48,1223
CID,IAH,601,284,6,11,902
CID,MSP,1779,262,5,39,2085
CID,ORD,4713,1136,4,262,6115
CLD,LAX,5239,973,4,132,6348
CLE,ABE,23,11,0,0,34
CLE,ALB,2636,554,1,53,3244
CLE,ATL,6279,1227,16,175,7697
CLE,BDL,807,129,2,7,945
CLE,BIL,0,0,1,0,1
CLE,BNA,1832,227,1,15,2075
CLE,BOS,1919,503,7,44,2473
CLE,BTV,803,222,3,21,1049
CLE,BUF,431,69,0,5,505
CLE,BWI,4487,708,14,79,5288
CLE,CHS,0,0,0,1,1
CLE,CLT,5339,826,14,85,6264
CLE,CMH,240,26,0,1,267
CLE,CVG,697,136,1,19,853
CLE,DAY,1023,202,0,19,1244
CLE,DCA,1774,391,5,65,2235
CLE,DEN,2795,502,14,24,3335
CLE,DFW,5113,1221,46,105,6485
CLE,DTW,1014,362,1,24,1401
CLE,EWR,4736,1313,10,127,6186
CLE,FLL,1377,181,2,6,1566
CLE,FNT,0,2,0,1,3
CLE,GRB,1256,251,3,29,1539
CLE,GRR,2028,423,2,26,2479
CLE,GSP,786,161,2,8,957
CLE,IAD,2719,622,6,70,3417
CLE,IAH,5540,808,18,27,6393
CLE,IND,1170,115,3,9,1297
CLE,JAX,154,27,0,2,183
CLE,JFK,1456,427,3,126,2012
CLE,LAS,3377,618,10,10,4015
CLE,LAX,2445,494,2,8,2949
CLE,LGA,5396,1321,20,345,7082
CLE,MCI,2803,628,10,32,3473
CLE,MCO,2489,314,5,7,2815
CLE,MDT,1,0,0,0,1
CLE,MDW,5763,917,11,77,6768
CLE,MEM,1092,172,4,29,1297
CLE,MHT,2022,439,3,41,2505
CLE,MIA,1847,353,10,30,2240
CLE,MKE,3140,616,9,48,3813
CLE,MSN,1026,220,3,14,1263
CLE,MSP,3887,627,10,74,4598
CLE,MSY,343,57,1,5,406
CLE,ORD,12654,3218,17,377,16266
CLE,ORF,700,79,0,14,793
CLE,PBI,758,115,1,6,880
CLE,PHL,970,341,5,39,1355
CLE,PHX,1387,237,5,7,1636
CLE,PIT,68,4,0,0,72
CLE,PVD,1343,251,4,16,1614
CLE,PWM,404,63,1,7,475
CLE,RDU,933,135,2,10,1080
CLE,RIC,2065,462,7,34,2568
CLE,ROC,925,181,1,18,1125
CLE,RSW,1356,151,0,4,1511
CLE,SAN,33,19,0,0,52
CLE,SDF,1536,225,5,11,1777
CLE,SEA,407,56,0,1,464
CLE,SFO,1438,341,2,15,1796
CLE,SJU,94,13,1,0,108
CLE,STL,1150,157,1,12,1320
CLE,SYR,482,95,2,3,582
CLE,TPA,1441,134,3,8,1586
CLE,TYS,469,84,1,2,556
CLL,DFW,1860,276,3,60,2199
CLL,IAH,650,76,0,22,748
CLT,ABE,842,192,1,15,1050
CLT,AGS,70,8,0,0,78
CLT,ALB,1828,335,5,25,2193
CLT,ATL,17631,3904,15,255,21805
CLT,AUS,2410,577,8,12,3007
CLT,AVL,0,0,0,1,1
CLT,AVP,287,54,1,6,348
CLT,BDL,4207,979,3,81,5270
CLT,BHM,1388,199,4,9,1600
CLT,BNA,4799,867,6,48,5720
CLT,BOS,9139,2640,4,169,11952
CLT,BUF,3452,684,4,33,4173
CLT,BWI,9402,2047,13,180,11642
CLT,CHS,4007,774,4,69,4854
CLT,CLE,5188,982,7,66,6243
CLT,CMH,478,49,0,4,531
CLT,CVG,2595,508,5,36,3144
CLT,DAB,604,131,2,3,740
CLT,DCA,6883,1503,15,139,8540
CLT,DEN,4406,1006,10,48,5470
CLT,DFW,11632,2307,54,279,14272
CLT,DTW,7748,1701,18,92,9559
CLT,EWR,10731,4237,27,497,15492
CLT,FAY,329,79,1,4,413
CLT,FLL,6856,1667,10,39,8572
CLT,GSO,999,134,0,17,1150
CLT,HNL,143,57,7,1,208
CLT,HSV,110,19,0,1,130
CLT,IAD,7080,1378,14,192,8664
CLT,IAH,11361,2597,48,120,14126
CLT,ILM,3733,602,4,50,4389
CLT,IND,1109,192,1,12,1314
CLT,JAX,6261,1116,7,42,7426
CLT,JFK,5150,1160,23,185,6518
CLT,LAS,4171,965,5,49,5190
CLT,LAX,3665,1112,11,7,4795
CLT,LGA,10371,3031,49,430,13881
CLT,LIT,1208,221,1,7,1437
CLT,MCI,2964,614,8,27,3613
CLT,MCO,7903,2074,6,34,10017
CLT,MDT,2693,558,4,46,3301
CLT,MEM,5697,1207,12,78,6994
CLT,MHT,385,61,0,7,453
CLT,MIA,8975,2148,34,118,11275
CLT,MSP,3785,674,5,48,4512
CLT,MSY,3930,690,7,47,4674
CLT,MYR,3551,652,2,61,4266
CLT,OAJ,252,55,0,3,310
CLT,OMA,209,16,0,1,226
CLT,ORD,14018,3598,49,439,18104
CLT,ORF,3543,617,2,72,4234
CLT,PBI,4486,927,7,29,5449
CLT,PDX,322,122,0,2,446
CLT,PHL,7829,2251,12,172,10264
CLT,PHX,6890,1443,12,36,8381
CLT,PIT,7595,1401,6,37,9039
CLT,PNS,1651,232,4,15,1902
CLT,PVD,4001,980,10,63,5054
CLT,PWM,912,200,3,12,1127
CLT,RDU,7336,1504,6,53,8899
CLT,RIC,4280,826,10,52,5168
CLT,ROC,931,278,2,7,1218
CLT,RSW,4402,949,6,20,5377
CLT,SAN,1586,290,7,11,1894
CLT,SAT,2447,516,6,13,2982
CLT,SAV,2742,542,3,25,3312
CLT,SDF,2160,442,0,29,2631
CLT,SEA,1680,428,7,10,2125
CLT,SFO,3422,1334,3,21,4780
CLT,SJU,2078,498,7,10,2593
CLT,SLC,453,70,0,6,529
CLT,SMF,177,61,0,3,241
CLT,SRQ,1374,277,3,10,1664
CLT,STL,3774,803,5,40,4622
CLT,STT,995,262,7,8,1272
CLT,STX,42,19,0,0,61
CLT,SYR,1870,408,4,15,2297
CLT,TLH,29,5,0,3,37
CLT,TPA,7089,1692,7,35,8823
CLT,TRI,18,0,0,1,19
CLT,TYS,19,2,0,1,22
CLT,VPS,25,5,0,0,30
CLT,XNA,2,0,0,0,2
CMH,ATL,8535,1258,16,122,9931
CMH,BNA,1749,281,1,8,2039
CMH,BOS,144,28,0,3,175
CMH,BWI,3928,913,14,60,4915
CMH,CLE,232,31,0,2,265
CMH,CLT,480,47,1,4,532
CMH,CRW,0,1,0,0,1
CMH,CVG,310,50,2,6,368
CMH,DCA,127,37,1,5,170
CMH,DEN,2138,310,17,13,2478
CMH,DFW,3767,685,17,71,4540
CMH,DTW,948,392,2,21,1363
CMH,EWR,2189,866,8,184,3247
CMH,FLL,663,133,1,1,798
CMH,IAD,1440,324,3,65,1832
CMH,IAH,3125,609,29,29,3792
CMH,JFK,1671,453,6,106,2236
CMH,LAS,1932,247,12,2,2193
CMH,LAX,323,101,1,0,425
CMH,LGA,4280,1009,16,306,5611
CMH,MCO,3543,535,3,9,4090
CMH,MDW,5560,1114,14,68,6756
CMH,MEM,513,73,1,16,603
CMH,MIA,1570,438,5,25,2038
CMH,MSP,1381,234,5,26,1646
CMH,ORD,10681,2693,18,352,13744
CMH,PHX,3028,380,5,21,3434
CMH,RDU,198,25,0,5,228
CMH,RSW,1333,186,7,5,1531
CMH,STL,1615,342,7,6,1970
CMH,TPA,2222,285,5,7,2519
CMI,DFW,918,146,7,25,1096
CMI,DTW,186,53,0,7,246
CMI,ORD,4654,799,2,196,5651
CMX,ORD,1653,306,4,115,2078
COD,DEN,1113,248,4,53,1418
COD,SLC,1592,244,3,37,1876
COS,ATL,1007,145,1,12,1165
COS,DEN,9070,2037,4,233,11344
COS,DFW,4624,664,13,119,5420
COS,IAD,722,198,3,11,934
COS,IAH,3622,1025,14,41,4702
COS,LAS,1,0,0,0,1
COS,LAX,2516,536,2,18,3072
COS,MAF,0,1,0,0,1
COS,MCO,13,6,0,0,19
COS,MSP,863,237,2,14,1116
COS,OKC,0,0,0,1,1
COS,ORD,3487,990,11,63,4551
COS,PDX,39,12,0,1,52
COS,PHX,194,32,0,0,226
COS,SAN,35,17,0,0,52
COS,SEA,62,26,0,0,88
COS,SFO,945,148,6,2,1101
COS,SLC,2090,248,3,23,2364
COU,ATL,266,48,0,2,316
COU,BHM,1,0,0,0,1
COU,MCO,6,6,0,0,12
COU,MEM,877,131,2,18,1028
CPR,DEN,3529,523,10,75,4137
CPR,MSP,0,0,1,0,1
CPR,RAP,0,1,0,0,1
CPR,SLC,2062,186,1,24,2273
CRP,DFW,7024,1147,19,221,8411
CRP,HOU,4157,639,11,99,4906
CRP,IAH,8011,1183,11,126,9331
CRW,ATL,3828,1059,12,128,5027
CRW,CVG,118,9,0,2,129
CRW,DTW,706,156,1,16,879
CRW,IAD,350,85,0,27,462
CRW,IAH,667,384,4,24,1079
CRW,LGA,743,153,8,32,936
CRW,MCO,334,55,0,4,393
CRW,ORD,2294,582,6,122,3004
CRW,TYS,0,1,0,0,1
CSG,ATL,3366,830,3,90,4289
CSG,DFW,1441,271,6,40,1758
CVG,ALB,187,53,0,3,243
CVG,ATL,5730,1095,14,73,6912
CVG,AUS,19,1,0,0,20
CVG,BDL,639,157,2,11,809
CVG,BNA,1339,196,3,19,1557
CVG,BOS,1529,518,5,24,2076
CVG,BUF,216,53,0,1,270
CVG,BWI,660,192,1,21,874
CVG,CLE,705,149,0,11,865
CVG,CLT,2512,489,4,44,3049
CVG,CMH,350,53,1,1,405
CVG,CRW,98,30,1,0,129
CVG,DAY,0,1,0,0,1
CVG,DCA,1152,344,4,63,1563
CVG,DEN,1570,273,6,17,1866
CVG,DFW,6186,1304,38,123,7651
CVG,DSM,38,8,0,0,46
CVG,DTW,1792,494,2,29,2317
CVG,EGE,6,0,1,1,8
CVG,EVV,260,65,1,4,330
CVG,EWR,3375,1748,20,345,5488
CVG,FLL,1718,228,7,16,1969
CVG,FWA,443,83,0,13,539
CVG,GRR,575,103,2,7,687
CVG,GSO,501,118,0,6,625
CVG,GSP,206,53,0,3,262
CVG,HPN,43,10,0,0,53
CVG,HSV,3,0,0,0,3
CVG,HTS,229,38,0,10,277
CVG,IAD,1563,359,8,65,1995
CVG,IAH,4098,1040,25,62,5225
CVG,IND,370,91,2,14,477
CVG,JAX,272,75,3,4,354
CVG,JFK,1355,580,15,93,2043
CVG,LAN,0,1,0,0,1
CVG,LAS,1397,239,2,11,1649
CVG,LAX,2180,451,5,7,2643
CVG,LEX,508,101,1,7,617
CVG,LGA,1798,711,7,95,2611
CVG,LIT,8,3,0,1,12
CVG,MCI,820,132,5,14,971
CVG,MCO,2678,436,7,19,3140
CVG,MDT,604,121,0,13,738
CVG,MEM,942,169,1,8,1120
CVG,MIA,2335,545,6,35,2921
CVG,MKE,1573,242,6,45,1866
CVG,MSN,296,87,3,5,391
CVG,MSP,2406,466,3,40,2915
CVG,MSY,348,102,1,7,458
CVG,OMA,472,78,1,6,557
CVG,ORD,8760,2404,16,475,11655
CVG,ORF,386,98,2,8,494
CVG,PBI,53,36,0,0,89
CVG,PHL,867,304,0,46,1217
CVG,PHX,795,113,0,5,913
CVG,PIT,782,145,1,17,945
CVG,RDU,722,143,2,4,871
CVG,RIC,220,57,0,12,289
CVG,ROC,90,16,1,2,109
CVG,RSW,1197,160,4,16,1377
CVG,SAN,486,71,3,1,561
CVG,SAT,59,43,0,2,104
CVG,SBN,477,91,0,15,583
CVG,SDF,391,97,0,5,493
CVG,SEA,837,133,2,4,976
CVG,SFO,1152,308,4,16,1480
CVG,SLC,2168,259,4,20,2451
CVG,SRQ,114,30,4,3,151
CVG,STL,951,209,1,22,1183
CVG,SYR,160,64,0,3,227
CVG,TPA,1406,208,1,11,1626
CVG,TYS,480,62,0,10,552
CVG,XNA,485,54,1,12,552
CWA,DTW,225,35,0,0,260
CWA,EAU,269,56,0,17,342
CWA,MKE,0,1,0,0,1
CWA,MSP,82,7,1,1,91
CWA,ORD,3599,904,2,268,4773
CWA,SYR,1,0,0,0,1
CYS,DFW,572,162,2,18,754
DAB,ATL,4164,910,5,75,5154
DAB,CLT,637,94,2,7,740
DAL,ABQ,6633,1549,11,49,8242
DAL,AMA,4886,1195,23,82,6186
DAL,ATL,435,70,0,11,516
DAL,AUS,9595,1971,9,97,11672
DAL,BHM,2439,608,8,11,3066
DAL,DEN,845,355,1,24,1225
DAL,ELP,5589,1377,14,84,7064
DAL,HOU,19397,4484,54,1120,25055
DAL,HRL,99,10,0,0,109
DAL,IAH,4441,1118,9,119,5687
DAL,LBB,4699,1367,13,91,6170
DAL,LIT,4857,1135,10,55,6057
DAL,MAF,4520,1153,4,74,5751
DAL,MCI,7322,1877,30,56,9285
DAL,MEM,905,121,3,31,1060
DAL,MSY,5341,1366,20,54,6781
DAL,OKC,3985,927,12,35,4959
DAL,SAT,11328,2156,13,149,13646
DAL,STL,6885,1479,17,50,8431
DAL,TUL,4434,1159,16,36,5645
DAY,ABE,0,0,1,0,1
DAY,ATL,7587,1389,15,122,9113
DAY,BWI,2678,317,6,41,3042
DAY,CLE,1125,183,0,23,1331
DAY,CMH,0,0,0,1,1
DAY,CVG,0,1,0,0,1
DAY,DEN,2327,331,10,13,2681
DAY,DFW,2572,486,13,60,3131
DAY,DTW,963,229,2,29,1223
DAY,EWR,2006,701,8,185,2900
DAY,IAD,2005,408,8,101,2522
DAY,IAH,905,238,3,11,1157
DAY,MCO,1100,97,3,6,1206
DAY,MKE,0,1,0,0,1
DAY,MSP,1994,297,4,33,2328
DAY,ORD,5756,1358,6,310,7430
DAY,ORF,1,0,0,0,1
DAY,TPA,456,89,0,0,545
DBQ,ORD,1289,212,0,96,1597
DCA,ATL,18371,3389,47,631,22438
DCA,AUS,135,38,2,2,177
DCA,BDL,1127,231,1,57,1416
DCA,BNA,3979,874,7,239,5099
DCA,BOS,20242,4372,9,877,25500
DCA,BTR,1,0,0,0,1
DCA,BUF,628,128,0,11,767
DCA,CLE,1895,276,1,64,2236
DCA,CLT,7203,1150,4,157,8514
DCA,CMH,137,23,0,9,169
DCA,CVG,1252,238,4,75,1569
DCA,DEN,3568,728,11,58,4365
DCA,DFW,9586,1711,99,350,11746
DCA,DSM,127,63,2,17,209
DCA,DTW,5415,1004,5,164,6588
DCA,EWR,3233,1658,8,419,5318
DCA,FLL,3818,880,20,70,4788
DCA,GRR,239,73,1,12,325
DCA,HSV,379,58,0,27,464
DCA,IAH,6791,1148,31,126,8096
DCA,IND,517,115,1,36,669
DCA,JAN,377,153,0,32,562
DCA,JAX,1039,230,1,24,1294
DCA,JFK,5942,1640,16,493,8091
DCA,LAS,899,167,2,15,1083
DCA,LAX,1090,182,1,22,1295
DCA,LEX,240,40,0,20,300
DCA,LGA,11291,2306,12,910,14519
DCA,MCI,1,0,0,0,1
DCA,MCO,6951,1359,16,135,8461
DCA,MEM,2358,405,3,70,2836
DCA,MIA,7951,1815,23,248,10037
DCA,MKE,3980,524,6,86,4596
DCA,MSN,307,93,1,18,419
DCA,MSP,4674,986,11,105,5776
DCA,MSY,186,22,0,4,212
DCA,ORD,17176,3960,47,1024,22207
DCA,PBI,1287,258,5,25,1575
DCA,PDX,109,15,0,2,126
DCA,PHL,816,204,0,17,1037
DCA,PHX,2761,448,7,46,3262
DCA,PLN,1,0,0,0,1
DCA,PVD,705,121,0,21,847
DCA,RDU,5980,996,3,463,7442
DCA,RSW,1548,172,3,26,1749
DCA,SAN,160,39,0,4,203
DCA,SEA,1897,260,2,20,2179
DCA,SFO,262,104,1,4,371
DCA,SJU,103,25,0,3,131
DCA,SLC,1068,188,2,17,1275
DCA,STL,3805,732,9,187,4733
DCA,SYR,129,18,0,3,150
DCA,TPA,4156,912,7,70,5145
DEN,ABQ,6559,1616,17,69,8261
DEN,AMA,2519,687,11,38,3255
DEN,ANC,880,243,0,4,1127
DEN,ASE,6970,1673,73,594,9310
DEN,ATL,13454,3250,67,130,16901
DEN,ATW,247,52,3,6,308
DEN,AUS,5704,1445,8,20,7177
DEN,AZA,40,7,0,0,47
DEN,BDL,757,260,0,7,1024
DEN,BFF,0,0,1,0,1
DEN,BFL,1002,237,2,15,1256
DEN,BHM,1035,273,4,5,1317
DEN,BIL,3914,792,10,53,4769
DEN,BIS,3066,797,16,67,3946
DEN,BKG,452,89,1,4,546
DEN,BLI,102,14,0,0,116
DEN,BNA,6088,1485,17,36,7626
DEN,BOI,6353,1488,15,33,7889
DEN,BOS,6375,1761,15,90,8241
DEN,BUR,3018,636,9,22,3685
DEN,BWI,6044,1404,23,85,7556
DEN,BZN,3268,651,20,32,3971
DEN,CAK,1507,547,3,10,2067
DEN,CID,1723,526,17,50,2316
DEN,CLE,2695,640,9,17,3361
DEN,CLT,4560,842,10,57,5469
DEN,CMH,1956,382,6,7,2351
DEN,COD,984,383,13,44,1424
DEN,COS,8718,2374,10,220,11322
DEN,CPR,3426,636,6,68,4136
DEN,CVG,1715,381,8,7,2111
DEN,DAL,976,241,7,13,1237
DEN,DAY,2084,550,5,8,2647
DEN,DCA,3448,863,13,42,4366
DEN,DFW,15727,3573,59,280,19639
DEN,DRO,5273,1410,15,176,6874
DEN,DSM,2940,684,9,34,3667
DEN,DTW,7055,1795,16,35,8901
DEN,EGE,2552,462,6,141,3161
DEN,ELP,2571,728,4,50,3353
DEN,EUG,1789,478,4,15,2286
DEN,EWR,5770,2144,28,150,8092
DEN,FAI,206,88,4,1,299
DEN,FAR,3026,750,11,64,3851
DEN,FAT,2494,728,14,39,3275
DEN,FCA,1467,380,8,17,1872
DEN,FLL,3333,863,12,6,4214
DEN,FSD,3168,790,10,58,4026
DEN,GCC,2028,381,5,41,2455
DEN,GEG,5328,1297,8,24,6657
DEN,GFK,147,29,0,3,179
DEN,GJT,5784,1222,8,168,7182
DEN,GRB,36,6,0,0,42
DEN,GRR,1216,311,2,6,1535
DEN,GTF,2109,456,9,25,2599
DEN,GUC,1391,282,7,59,1739
DEN,HDN,2573,482,4,87,3146
DEN,HLN,1490,292,1,17,1800
DEN,HNL,1007,169,21,11,1208
DEN,HOU,4223,974,12,18,5227
DEN,HSV,1505,384,8,19,1916
DEN,IAD,8538,1809,15,178,10540
DEN,IAH,9828,2096,26,56,12006
DEN,ICT,3606,875,6,49,4536
DEN,IDA,2423,510,4,50,2987
DEN,IND,5034,1400,15,24,6473
DEN,ISN,120,40,0,8,168
DEN,JAC,2978,592,14,95,3679
DEN,JAX,469,105,1,1,576
DEN,JFK,1751,380,11,43,2185
DEN,KOA,159,22,4,0,185
DEN,LAR,96,12,0,7,115
DEN,LAS,18553,3880,12,91,22536
DEN,LAX,20393,5079,28,242,25742
DEN,LBB,950,202,3,37,1192
DEN,LGA,6122,2379,62,171,8734
DEN,LGB,32,12,0,2,46
DEN,LIH,126,14,7,0,147
DEN,LIT,2448,713,15,51,3227
DEN,LNK,2320,628,8,52,3008
DEN,MAF,1776,382,6,21,2185
DEN,MCI,10619,2737,29,104,13489
DEN,MCO,7196,1574,18,17,8805
DEN,MDT,53,15,0,0,68
DEN,MDW,10525,2459,50,137,13171
DEN,MEM,1783,521,7,34,2345
DEN,MFR,1293,329,4,14,1640
DEN,MHT,372,84,0,1,457
DEN,MIA,1759,331,7,17,2114
DEN,MKE,6529,1664,21,46,8260
DEN,MLI,1553,374,5,16,1948
DEN,MOT,1797,488,8,53,2346
DEN,MRY,881,219,13,8,1121
DEN,MSN,2702,745,14,37,3498
DEN,MSO,3234,754,16,43,4047
DEN,MSP,14025,3386,25,115,17551
DEN,MSY,4058,859,11,22,4950
DEN,MTJ,3316,774,10,100,4200
DEN,OAK,4511,999,1,26,5537
DEN,OGG,378,59,7,2,446
DEN,OKC,5909,1500,17,64,7490
DEN,OMA,6418,1550,15,46,8029
DEN,ONT,4007,883,3,28,4921
DEN,ORD,12184,3144,27,316,15671
DEN,PDX,10622,2617,9,37,13285
DEN,PHF,421,83,1,5,510
DEN,PHL,6968,1810,22,122,8922
DEN,PHX,19705,4431,25,164,24325
DEN,PIA,884,209,8,23,1124
DEN,PIT,1958,415,2,14,2389
DEN,PSC,2470,579,9,26,3084
DEN,PSP,2809,673,16,21,3519
DEN,PVD,292,63,3,1,359
DEN,RAP,5461,1298,18,183,6960
DEN,RDM,891,259,5,6,1161
DEN,RDU,833,301,1,0,1135
DEN,RFD,46,13,0,1,60
DEN,RKS,2307,353,3,80,2743
DEN,RNO,3812,803,4,25,4644
DEN,RSW,390,72,2,1,465
DEN,SAN,11678,2592,37,70,14377
DEN,SAT,4253,1060,8,18,5339
DEN,SBA,1967,423,10,27,2427
DEN,SBN,41,7,0,0,48
DEN,SDF,1248,297,5,4,1554
DEN,SEA,14000,3074,13,52,17139
DEN,SFO,12929,5175,12,147,18263
DEN,SGF,1776,481,8,42,2307
DEN,SHV,113,13,0,0,126
DEN,SJC,6723,1392,3,58,8176
DEN,SLC,18416,4590,23,129,23158
DEN,SMF,8891,2030,15,44,10980
DEN,SNA,10461,1710,19,56,12246
DEN,STL,5864,1655,10,39,7568
DEN,TPA,4081,896,15,8,5000
DEN,TUL,5550,1449,20,64,7083
DEN,TUS,6980,1874,14,37,8905
DEN,TVC,170,69,2,0,241
DEN,TYS,1207,335,6,8,1556
DEN,XNA,1287,349,9,45,1690
DFW,ABI,5826,1432,4,154,7416
DFW,ABQ,6542,1689,14,173,8418
DFW,ACT,1530,278,2,66,1876
DFW,AEX,2780,636,2,75,3493
DFW,AGS,939,218,6,19,1182
DFW,AMA,4948,1062,19,170,6199
DFW,ANC,270,165,2,1,438
DFW,ASE,114,64,11,14,203
DFW,ATL,21569,4611,65,549,26794
DFW,AUS,12382,3327,10,284,16003
DFW,AVL,213,68,1,1,283
DFW,BDL,2409,705,8,58,3180
DFW,BHM,2467,662,6,65,3200
DFW,BMI,903,177,3,13,1096
DFW,BNA,6379,1666,12,147,8204
DFW,BOS,6446,2421,16,295,9178
DFW,BRO,1757,396,7,57,2217
DFW,BTR,6734,1409,26,230,8399
DFW,BUR,2170,558,14,34,2776
DFW,BWI,4626,1653,26,156,6461
DFW,CAE,2509,645,8,44,3206
DFW,CHA,1118,275,2,26,1421
DFW,CHS,2454,686,21,45,3206
DFW,CID,4411,1027,33,120,5591
DFW,CLE,4677,1363,12,109,6161
DFW,CLL,1760,381,3,55,2199
DFW,CLT,11420,2528,33,296,14277
DFW,CMH,3330,1131,11,66,4538
DFW,CMI,784,289,4,19,1096
DFW,COS,4169,1122,21,108,5420
DFW,CRP,6806,1386,19,200,8411
DFW,CSG,1446,276,3,34,1759
DFW,CVG,6005,1528,16,112,7661
DFW,CYS,624,114,5,11,754
DFW,DAY,2375,690,11,55,3131
DFW,DCA,8680,2650,80,335,11745
DFW,DEN,15737,3481,33,292,19543
DFW,DRO,389,78,3,4,474
DFW,DSM,4670,1292,23,95,6080
DFW,DTW,6115,1577,18,135,7845
DFW,EGE,835,362,14,15,1226
DFW,ELP,6356,1773,20,186,8335
DFW,EVV,1292,288,3,20,1603
DFW,EWR,7317,2693,56,385,10451
DFW,FAT,1616,526,3,23,2168
DFW,FAY,929,211,6,19,1165
DFW,FLL,4732,1460,20,69,6281
DFW,FSD,1374,434,9,26,1843
DFW,FSM,2416,533,5,82,3036
DFW,FWA,1813,475,5,28,2321
DFW,GCK,455,83,1,6,545
DFW,GGG,1118,207,0,50,1375
DFW,GJT,1879,543,5,25,2452
DFW,GPT,2985,790,12,76,3863
DFW,GRB,0,1,0,0,1
DFW,GRI,884,161,4,11,1060
DFW,GRK,4555,962,5,177,5699
DFW,GRR,2329,694,10,38,3071
DFW,GSO,2351,638,2,40,3031
DFW,GSP,2992,787,5,63,3847
DFW,GUC,288,125,9,17,439
DFW,HDN,260,93,5,6,364
DFW,HNL,1592,573,19,8,2192
DFW,HOU,6183,1416,18,197,7814
DFW,HSV,2402,614,5,76,3097
DFW,IAD,5901,1470,26,244,7641
DFW,IAH,11279,2657,26,238,14200
DFW,ICT,3211,849,6,102,4168
DFW,IND,4109,1134,11,81,5335
DFW,JAC,401,213,7,4,625
DFW,JAN,6603,1452,19,201,8275
DFW,JAX,3237,818,12,54,4121
DFW,JFK,1070,367,19,39,1495
DFW,JLN,564,91,3,13,671
DFW,LAN,1,0,0,0,1
DFW,LAS,10464,2636,30,172,13302
DFW,LAW,1455,225,6,41,1727
DFW,LAX,17196,5043,29,352,22620
DFW,LBB,5643,1400,14,217,7274
DFW,LCH,1733,398,4,51,2186
DFW,LEX,2487,595,7,53,3142
DFW,LFT,2960,732,16,104,3812
DFW,LGA,11269,3246,122,641,15278
DFW,LIT,6721,1913,9,242,8885
DFW,LRD,3322,795,7,88,4212
DFW,MAF,3853,906,11,96,4866
DFW,MCI,6623,1630,18,180,8451
DFW,MCO,8519,2535,29,126,11209
DFW,MEM,4306,958,7,188,5459
DFW,MFE,3231,809,7,145,4192
DFW,MGM,2404,577,3,64,3048
DFW,MHK,2471,617,13,50,3151
DFW,MIA,7513,3079,30,143,10765
DFW,MKE,3926,1082,19,77,5104
DFW,MLI,1851,573,10,45,2479
DFW,MLU,1509,352,7,50,1918
DFW,MOB,2607,663,3,64,3337
DFW,MSN,2184,580,8,50,2822
DFW,MSP,6455,1713,22,133,8323
DFW,MSY,4967,1303,16,115,6401
DFW,MTJ,522,156,3,6,687
DFW,MYR,165,41,1,2,209
DFW,OGG,826,287,11,4,1128
DFW,OKC,5851,1595,4,129,7579
DFW,OMA,4106,1065,14,80,5265
DFW,ONT,3459,1015,13,49,4536
DFW,ORD,17014,5119,71,501,22705
DFW,ORF,1803,612,16,41,2472
DFW,PBI,1660,624,8,28,2320
DFW,PDX,3438,1231,7,44,4720
DFW,PHL,8802,2372,32,286,11492
DFW,PHX,12308,2557,26,181,15072
DFW,PIA,2120,631,3,48,2802
DFW,PIT,2910,950,11,57,3928
DFW,PNS,4619,1272,11,111,6013
DFW,PSP,2079,558,21,27,2685
DFW,RAP,910,207,8,21,1146
DFW,RDU,3976,1197,9,88,5270
DFW,RIC,2320,702,12,61,3095
DFW,RNO,2050,655,13,28,2746
DFW,ROW,2598,599,13,57,3267
DFW,RSW,1825,668,10,27,2530
DFW,SAF,2194,556,19,49,2818
DFW,SAN,7193,2218,52,104,9567
DFW,SAT,12375,3272,24,262,15933
DFW,SAV,2299,620,10,31,2960
DFW,SDF,3315,823,7,74,4219
DFW,SEA,8687,2346,17,85,11135
DFW,SFO,10081,4428,34,226,14769
DFW,SGF,6318,1577,16,172,8083
DFW,SHV,3367,648,8,121,4144
DFW,SJC,4328,1311,14,71,5724
DFW,SJT,1317,289,2,37,1645
DFW,SJU,1454,706,7,11,2178
DFW,SLC,6839,1795,19,112,8765
DFW,SMF,3167,1082,11,41,4301
DFW,SNA,8439,1928,44,202,10613
DFW,SPI,1008,190,1,20,1219
DFW,SPS,1352,254,5,69,1680
DFW,STL,7481,1721,13,195,9410
DFW,TLH,1007,231,2,14,1254
DFW,TPA,5720,1658,21,91,7490
DFW,TUL,6414,2083,15,180,8692
DFW,TUS,5590,1666,12,88,7356
DFW,TXK,2466,544,2,109,3121
DFW,TYR,2648,520,3,87,3258
DFW,TYS,3547,970,12,83,4612
DFW,VPS,4413,1299,20,115,5847
DFW,XNA,6712,1703,9,248,8672
DHN,ATL,3185,777,1,92,4055
DHN,PNS,0,0,1,0,1
DLG,ANC,213,28,0,3,244
DLH,DTW,590,116,2,19,727
DLH,MSP,2824,348,2,97,3271
DLH,ORD,1871,431,2,79,2383
DRO,DEN,5566,1117,9,184,6876
DRO,DFW,389,73,3,9,474
DRO,MCI,0,1,0,0,1
DRO,PHX,2139,175,1,30,2345
DRO,SHV,0,1,0,0,1
DRO,SLC,0,2,0,0,2
DRT,IAH,336,26,2,8,372
DSM,ATL,2010,460,8,40,2518
DSM,ATW,1,0,0,0,1
DSM,BKG,78,29,0,1,108
DSM,CVG,39,6,1,0,46
DSM,DCA,127,69,0,12,208
DSM,DEN,3339,663,6,39,4047
DSM,DFW,4878,1056,28,118,6080
DSM,DTW,486,80,3,6,575
DSM,EWR,476,54,1,21,552
DSM,IAH,1444,466,6,31,1947
DSM,LNK,0,1,0,0,1
DSM,MCO,118,23,0,0,141
DSM,MDW,153,31,0,2,186
DSM,MEM,1519,258,5,32,1814
DSM,MKE,1620,265,3,28,1916
DSM,MLI,0,0,1,0,1
DSM,MSP,1465,345,0,33,1843
DSM,ORD,9019,2235,10,373,11637
DSM,PHX,1930,238,6,29,2203
DTW,ABE,1096,233,4,27,1360
DTW,ALB,1088,305,7,38,1438
DTW,ANC,75,61,0,0,136
DTW,APN,73,6,0,3,82
DTW,ATL,12637,2533,31,118,15319
DTW,ATW,1316,327,7,44,1694
DTW,AUS,449,137,0,5,591
DTW,AVL,730,179,2,21,932
DTW,AVP,905,193,4,31,1133
DTW,AZO,1359,319,2,62,1742
DTW,BDL,3145,722,8,48,3923
DTW,BGM,742,166,3,20,931
DTW,BGR,1359,428,3,30,1820
DTW,BHM,1060,312,5,20,1397
DTW,BMI,634,148,0,9,791
DTW,BNA,5246,1054,8,92,6400
DTW,BOS,4658,1342,9,90,6099
DTW,BTV,764,278,3,40,1085
DTW,BUF,1314,394,2,38,1748
DTW,BWI,7776,1791,24,151,9742
DTW,BZN,15,2,0,0,17
DTW,CAE,548,145,1,6,700
DTW,CAK,795,194,1,27,1017
DTW,CHA,609,104,0,5,718
DTW,CHO,196,48,0,10,254
DTW,CHS,542,169,3,9,723
DTW,CID,1030,247,11,43,1331
DTW,CLE,1086,231,0,22,1339
DTW,CLT,7857,1657,13,94,9621
DTW,CMH,971,286,1,28,1286
DTW,CMI,192,45,1,8,246
DTW,CRW,726,130,2,16,874
DTW,CVG,1681,463,2,44,2190
DTW,CWA,215,42,3,0,260
DTW,DAY,968,211,0,27,1206
DTW,DCA,5206,1183,10,139,6538
DTW,DEN,7344,1576,25,32,8977
DTW,DFW,6137,1159,47,116,7459
DTW,DLH,580,129,5,16,730
DTW,DSM,485,136,0,7,628
DTW,EGE,3,4,0,1,8
DTW,ELM,2590,569,5,36,3200
DTW,ERI,945,244,8,42,1239
DTW,ESC,106,20,2,3,131
DTW,EVV,1112,267,3,28,1410
DTW,EWR,5390,2342,20,494,8246
DTW,FLL,4109,829,9,22,4969
DTW,FNT,1265,338,0,30,1633
DTW,FSD,334,93,2,15,444
DTW,FWA,1160,367,1,14,1542
DTW,GRB,1833,502,4,41,2380
DTW,GRR,3219,812,9,44,4084
DTW,GSO,912,248,1,25,1186
DTW,GSP,1066,256,8,20,1350
DTW,HNL,45,26,2,0,73
DTW,HPN,27,4,0,3,34
DTW,HSV,812,192,3,14,1021
DTW,IAD,3363,931,10,122,4426
DTW,IAH,5634,1384,28,62,7108
DTW,ICT,181,68,3,3,255
DTW,IND,3616,723,3,39,4381
DTW,ITH,749,158,7,33,947
DTW,JAN,433,147,3,19,602
DTW,JAX,1428,267,7,20,1722
DTW,JFK,1464,753,6,77,2300
DTW,LAN,1623,380,1,47,2051
DTW,LAS,4830,1152,13,14,6009
DTW,LAX,4456,1261,9,22,5748
DTW,LEX,1465,302,3,27,1797
DTW,LGA,10832,2844,31,566,14273
DTW,LIT,610,140,2,12,764
DTW,LSE,409,103,2,8,522
DTW,MBS,2021,527,1,53,2602
DTW,MCI,2653,662,15,49,3379
DTW,MCO,7094,1505,9,16,8624
DTW,MDT,1320,277,6,28,1631
DTW,MDW,6490,1554,20,137,8201
DTW,MEM,2866,590,8,22,3486
DTW,MHT,956,292,2,14,1264
DTW,MIA,3507,645,7,32,4191
DTW,MKE,3492,747,5,44,4288
DTW,MLI,790,212,2,11,1015
DTW,MQT,33,6,0,2,41
DTW,MSN,2767,749,9,57,3582
DTW,MSP,7759,1798,12,45,9614
DTW,MSY,1458,257,5,26,1746
DTW,MYR,210,36,0,2,248
DTW,OKC,1094,415,4,24,1537
DTW,OMA,1654,547,3,38,2242
DTW,ORD,13165,3623,15,532,17335
DTW,ORF,1310,345,4,53,1712
DTW,PBI,1320,270,5,5,1600
DTW,PDX,393,166,1,2,562
DTW,PHL,4837,1322,7,158,6324
DTW,PHX,7757,1292,22,27,9098
DTW,PIA,518,130,0,17,665
DTW,PIT,2302,587,2,54,2945
DTW,PLN,276,88,1,21,386
DTW,PVD,1544,444,5,51,2044
DTW,PWM,916,286,11,23,1236
DTW,RDU,2638,520,3,35,3196
DTW,RIC,775,184,1,25,985
DTW,ROA,750,188,9,29,976
DTW,ROC,769,201,1,20,991
DTW,RST,415,105,3,13,536
DTW,RSW,3127,625,7,18,3777
DTW,SAN,1790,433,10,8,2241
DTW,SAT,1100,277,3,5,1385
DTW,SAV,551,141,1,7,700
DTW,SBN,1632,351,3,28,2014
DTW,SCE,764,193,1,22,980
DTW,SDF,699,206,2,11,918
DTW,SEA,3084,747,6,8,3845
DTW,SFO,2942,993,7,13,3955
DTW,SGF,70,12,0,1,83
DTW,SJU,91,17,1,0,109
DTW,SLC,3376,948,7,14,4345
DTW,SMF,93,67,0,1,161
DTW,SNA,166,53,0,1,220
DTW,SRQ,228,59,0,0,287
DTW,STL,4289,839,10,44,5182
DTW,SWF,805,187,9,36,1037
DTW,SYR,1093,345,4,32,1474
DTW,TOL,29,2,0,1,32
DTW,TPA,4313,905,10,18,5246
DTW,TRI,430,75,2,5,512
DTW,TUL,1187,447,3,33,1670
DTW,TVC,1572,396,5,50,2023
DTW,TYS,896,214,0,6,1116
DTW,XNA,663,140,2,6,811
EAU,CWA,285,31,13,13,342
EAU,ORD,1590,414,1,60,2065
ECP,ATL,5716,1328,8,113,7165
ECP,BNA,1665,234,0,4,1903
ECP,BWI,1558,263,4,19,1844
ECP,HOU,1633,301,5,9,1948
ECP,MCO,1572,261,2,8,1843
ECP,MEM,1102,171,2,33,1308
ECP,STL,52,18,0,0,70
EGE,ATL,250,44,4,12,310
EGE,CVG,6,1,0,1,8
EGE,DEN,2695,340,3,137,3175
EGE,DFW,1042,165,0,19,1226
EGE,DTW,1,6,0,1,8
EGE,EWR,209,95,5,14,323
EGE,IAH,256,62,3,6,327
EGE,JFK,259,51,11,10,331
EGE,LAX,268,56,0,10,334
EGE,LGA,34,7,3,2,46
EGE,MIA,226,50,3,2,281
EGE,MSP,74,11,0,3,88
EGE,ORD,304,69,2,5,380
EKO,SLC,3332,355,6,78,3771
ELM,DTW,2668,487,1,42,3198
ELP,ABQ,1623,247,4,3,1877
ELP,ATL,1942,405,15,24,2386
ELP,AUS,2984,582,7,16,3589
ELP,DAL,5815,1142,38,69,7064
ELP,DEN,2722,566,15,54,3357
ELP,DFW,7067,1047,23,198,8335
ELP,HOU,2598,418,9,18,3043
ELP,IAH,5131,869,22,54,6076
ELP,LAS,2735,492,1,12,3240
ELP,LAX,4793,890,7,41,5731
ELP,MAF,0,0,1,0,1
ELP,ORD,2978,772,17,92,3859
ELP,PHX,10084,1449,4,87,11624
ELP,SAN,942,145,5,0,1092
ELP,SAT,2503,512,2,7,3024
ELP,SLC,42,29,0,0,71
ERI,DTW,875,317,0,47,1239
ESC,DTW,111,17,0,3,131
ESC,IMT,106,15,0,10,131
EUG,CEC,0,0,0,1,1
EUG,DEN,1967,283,9,25,2284
EUG,LAX,1,0,0,0,1
EUG,OTH,0,0,1,0,1
EUG,PDX,3707,317,3,67,4094
EUG,SFO,4572,1990,10,233,6805
EUG,SLC,1961,109,3,5,2078
EVV,ATL,2830,620,4,72,3526
EVV,CVG,304,25,0,5,334
EVV,DFW,1293,275,11,24,1603
EVV,DTW,1060,195,5,30,1290
EVV,MEM,337,51,1,7,396
EVV,ORD,3286,573,11,152,4022
EWN,ATL,2299,421,10,49,2779
EWR,ABQ,1,1,0,0,2
EWR,ALB,650,219,4,60,933
EWR,ATL,11544,3733,46,685,16008
EWR,AUS,2131,550,3,51,2735
EWR,AVL,959,165,3,85,1212
EWR,BDL,799,379,3,55,1236
EWR,BNA,3406,1492,12,204,5114
EWR,BOS,8365,2675,1,269,11310
EWR,BQN,545,231,1,11,788
EWR,BTV,1632,533,12,140,2317
EWR,BUF,1141,460,2,107,1710
EWR,BWI,2967,1069,7,225,4268
EWR,BZN,11,4,0,0,15
EWR,CAE,18,10,0,3,31
EWR,CHS,2347,806,20,189,3362
EWR,CLE,4955,1159,6,112,6232
EWR,CLT,12146,2794,32,500,15472
EWR,CMH,2292,724,14,178,3208
EWR,CVG,3694,1545,18,332,5589
EWR,DAY,1799,921,4,179,2903
EWR,DCA,3267,1636,11,407,5321
EWR,DEN,6220,1688,21,171,8100
EWR,DFW,8237,1770,65,381,10453
EWR,DSM,312,215,1,23,551
EWR,DTW,6084,2091,19,550,8744
EWR,EGE,233,75,8,7,323
EWR,FLL,8721,2759,21,221,11722
EWR,GRR,1337,554,12,65,1968
EWR,GSO,2534,1072,9,259,3874
EWR,GSP,1655,656,6,124,2441
EWR,HDN,39,10,1,2,52
EWR,HNL,819,259,6,12,1096
EWR,HOU,772,324,2,18,1116
EWR,IAD,2017,729,1,123,2870
EWR,IAH,9406,2441,25,160,12032
EWR,IND,3248,1018,8,157,4431
EWR,JAC,6,7,0,0,13
EWR,JAX,2536,932,9,114,3591
EWR,LAS,4696,1601,17,96,6410
EWR,LAX,6001,2340,24,156,8521
EWR,LEX,6,3,0,0,9
EWR,LIT,397,304,4,19,724
EWR,MCI,3219,1485,22,224,4950
EWR,MCO,11085,3244,23,246,14598
EWR,MDT,9,9,0,3,21
EWR,MDW,2750,769,10,124,3653
EWR,MEM,2330,826,14,240,3410
EWR,MHT,2316,732,1,172,3221
EWR,MIA,6370,1692,29,192,8283
EWR,MKE,2014,873,14,143,3044
EWR,MSN,671,238,6,24,939
EWR,MSP,4429,1336,28,210,6003
EWR,MSY,1790,532,5,61,2388
EWR,MTJ,45,15,1,2,63
EWR,MYR,198,26,0,20,244
EWR,OKC,565,429,13,35,1042
EWR,OMA,1820,794,11,118,2743
EWR,ORD,15720,4455,45,1089,21309
EWR,ORF,1322,562,3,137,2024
EWR,PBI,5445,1838,14,137,7434
EWR,PDX,1313,458,3,30,1804
EWR,PHL,91,68,1,17,177
EWR,PHX,6624,1617,13,150,8404
EWR,PIT,1345,422,4,138,1909
EWR,PVD,2016,631,3,144,2794
EWR,PWM,922,387,3,85,1397
EWR,RDU,2011,724,5,132,2872
EWR,RIC,3190,1647,2,159,4998
EWR,ROC,1403,458,2,130,1993
EWR,RSW,3670,737,7,75,4489
EWR,SAN,2505,877,13,54,3449
EWR,SAT,1290,421,6,29,1746
EWR,SAV,2001,847,5,165,3018
EWR,SBN,9,0,0,0,9
EWR,SDF,1838,857,6,147,2848
EWR,SEA,4414,1420,10,74,5918
EWR,SFO,6112,2563,53,177,8905
EWR,SJU,1656,439,4,30,2129
EWR,SLC,1410,334,1,24,1769
EWR,SNA,2071,547,11,45,2674
EWR,STL,4250,1679,18,273,6220
EWR,STT,554,92,1,6,653
EWR,SYR,551,241,0,27,819
EWR,TPA,5227,1582,18,120,6947
EWR,TUL,564,368,5,33,970
EWR,TYS,746,446,3,23,1218
EWR,XNA,1087,376,6,115,1584
EYW,ATL,2783,603,7,111,3504
EYW,LGA,1,1,0,0,2
EYW,MCO,901,75,1,4,981
EYW,MIA,253,24,0,2,279
EYW,TPA,590,43,1,3,637
FAI,ANC,6398,719,1,49,7167
FAI,BRW,847,212,1,25,1085
FAI,DEN,189,105,0,3,297
FAI,MSP,431,117,1,5,554
FAI,SCC,935,125,23,5,1088
FAI,SEA,2897,355,9,7,3268
FAI,SLC,50,3,0,0,53
FAR,DEN,3185,565,14,90,3854
FAR,MSP,3923,613,2,84,4622
FAR,ORD,5263,1184,9,243,6699
FAR,SLC,1125,143,2,11,1281
FAT,CIC,1,0,0,0,1
FAT,DEN,2706,483,13,70,3272
FAT,DFW,1787,340,10,31,2168
FAT,LAS,3827,936,9,85,4857
FAT,LAX,8927,1518,17,118,10580
FAT,LGB,0,1,0,0,1
FAT,LMT,2,0,0,0,2
FAT,MSP,1,0,0,0,1
FAT,PHX,4413,420,5,56,4894
FAT,SEA,543,50,1,4,598
FAT,SFO,3912,1834,8,64,5818
FAT,SLC,2718,238,9,26,2991
FAY,ATL,7255,1658,17,168,9098
FAY,CLT,354,53,0,6,413
FAY,DFW,915,213,16,21,1165
FCA,ATL,26,4,0,0,30
FCA,DEN,1614,227,6,24,1871
FCA,MSP,573,73,1,6,653
FCA,ORD,216,85,5,4,310
FCA,SLC,3290,185,4,32,3511
FLG,DRO,0,1,0,0,1
FLG,PHX,5803,537,1,235,6576
FLL,ABE,139,14,0,0,153
FLL,ALB,936,154,0,8,1098
FLL,ATL,18902,3484,40,171,22597
FLL,AUS,1680,502,6,7,2195
FLL,BDL,2043,528,3,47,2621
FLL,BNA,1862,330,5,4,2201
FLL,BOS,4202,1400,8,87,5697
FLL,BUF,1614,408,1,8,2031
FLL,BWI,6912,1356,26,99,8393
FLL,CAK,53,2,0,0,55
FLL,CLE,1385,167,2,7,1561
FLL,CLT,7439,1060,18,58,8575
FLL,CMH,647,136,4,2,789
FLL,CVG,1710,238,4,17,1969
FLL,DCA,3922,781,17,67,4787
FLL,DEN,3489,680,21,6,4196
FLL,DFW,5143,1024,36,77,6280
FLL,DTW,4231,701,8,28,4968
FLL,EWR,8250,3223,39,220,11732
FLL,FNT,26,29,0,0,55
FLL,HOU,1716,458,9,3,2186
FLL,HPN,2220,752,29,72,3073
FLL,IAD,1461,407,3,17,1888
FLL,IAH,4522,668,11,19,5220
FLL,IND,678,133,5,4,820
FLL,ISP,2016,466,14,37,2533
FLL,JAX,3503,705,4,16,4228
FLL,JFK,9471,3167,47,259,12944
FLL,LAS,1074,240,7,4,1325
FLL,LAX,1976,373,10,13,2372
FLL,LEX,145,36,1,0,182
FLL,LGA,8485,2710,83,293,11571
FLL,LGB,337,127,1,1,466
FLL,MCI,765,143,2,4,914
FLL,MCO,3964,698,3,25,4690
FLL,MDT,112,16,0,1,129
FLL,MDW,3526,716,16,28,4286
FLL,MEM,1066,156,3,4,1229
FLL,MHT,123,42,0,1,166
FLL,MKE,810,175,4,2,991
FLL,MSP,1217,257,2,14,1490
FLL,MSY,1627,255,4,4,1890
FLL,ORD,2869,859,11,30,3769
FLL,PHL,6691,1361,16,110,8178
FLL,PHX,2189,379,7,13,2588
FLL,PIT,1475,293,6,13,1787
FLL,PVD,1426,319,12,14,1771
FLL,RDU,1732,434,3,8,2177
FLL,RIC,845,227,1,9,1082
FLL,SEA,142,26,0,0,168
FLL,SFO,1267,565,5,8,1845
FLL,SJU,3154,893,4,22,4073
FLL,SLC,75,7,1,0,83
FLL,STL,927,217,5,4,1153
FLL,SWF,706,359,4,18,1087
FLL,TLH,786,105,11,27,929
FLL,TPA,6135,1043,8,44,7230
FLO,ATL,205,68,1,11,285
FNT,ATL,6009,1115,26,100,7250
FNT,CLE,0,2,0,1,3
FNT,DTW,1339,287,0,35,1661
FNT,FLL,39,16,0,0,55
FNT,MCO,929,96,1,1,1027
FNT,MSP,768,70,2,14,854
FNT,ORD,248,70,1,4,323
FNT,RSW,361,84,1,0,446
FNT,TPA,468,81,3,1,553
FSD,ATL,112,12,0,0,124
FSD,CLE,0,1,0,1,2
FSD,DEN,3318,637,10,63,4028
FSD,DFW,1501,301,9,32,1843
FSD,DTW,335,86,1,21,443
FSD,MSP,3232,585,3,67,3887
FSD,ORD,5778,1393,9,248,7428
FSM,ATL,381,33,0,1,415
FSM,DFW,2536,407,3,89,3035
FSM,MEM,1084,106,0,28,1218
FWA,ATL,1147,234,3,24,1408
FWA,CVG,460,71,0,11,542
FWA,DFW,1941,332,14,34,2321
FWA,DTW,1188,357,2,37,1584
FWA,MSP,147,29,0,6,182
FWA,ORD,4683,979,1,275,5938
GCC,DEN,1975,432,2,46,2455
GCC,RKS,944,110,21,21,1096
GCC,SLC,1009,73,1,14,1097
GCK,DFW,503,33,2,6,544
GEG,BOI,2206,250,3,5,2464
GEG,DEN,5951,642,9,38,6640
GEG,LAS,1991,190,3,5,2189
GEG,MSP,1997,374,5,25,2401
GEG,OAK,1890,207,1,1,2099
GEG,ORD,72,30,0,2,104
GEG,PDX,2163,291,0,20,2474
GEG,PHX,2579,204,4,14,2801
GEG,SEA,5512,527,3,78,6120
GEG,SFO,1739,639,11,70,2459
GEG,SLC,5040,556,9,46,5651
GFK,DEN,158,17,0,3,178
GFK,MSP,3681,581,9,160,4431
GGG,DFW,1169,153,4,50,1376
GJT,ABQ,0,1,0,0,1
GJT,ASE,0,1,4,1,6
GJT,CLE,1,0,0,1,2
GJT,COS,0,1,0,0,1
GJT,DEN,5980,1015,13,181,7189
GJT,DFW,1976,428,13,35,2452
GJT,HDN,0,0,2,0,2
GJT,IAH,724,145,4,9,882
GJT,LAX,1,0,0,1,2
GJT,ORD,0,1,0,1,2
GJT,PHX,2759,280,1,47,3087
GJT,SLC,2422,197,3,22,2644
GNV,ATL,5552,1416,10,102,7080
GNV,MIA,855,123,3,20,1001
GNV,MSY,1,0,0,0,1
GPT,ATL,4965,1484,9,145,6603
GPT,BKG,42,5,0,0,47
GPT,DFW,3164,588,18,93,3863
GPT,IAH,3891,831,14,103,4839
GPT,JAX,2,0,0,0,2
GPT,MEM,1352,187,2,29,1570
GPT,PNS,0,0,0,1,1
GPT,TPA,159,25,0,0,184
GRB,CLE,1362,150,0,27,1539
GRB,CMX,0,1,0,0,1
GRB,DEN,37,6,0,0,43
GRB,DFW,0,1,0,0,1
GRB,DTW,1655,388,1,45,2089
GRB,MQT,295,102,0,18,415
GRB,MSP,2425,382,0,53,2860
GRB,ORD,6750,1521,4,376,8651
GRB,TVC,1,0,0,0,1
GRI,DFW,925,118,3,13,1059
GRK,ATL,1666,319,4,45,2034
GRK,DFW,4760,746,4,189,5699
GRK,IAH,807,67,0,10,884
GRR,ATL,2340,564,12,58,2974
GRR,BWI,1982,221,5,28,2236
GRR,CLE,2035,384,4,28,2451
GRR,CVG,546,79,4,9,638
GRR,DCA,272,67,1,9,349
GRR,DEN,843,192,5,8,1048
GRR,DFW,2446,541,25,59,3071
GRR,DTW,3624,734,5,61,4424
GRR,EWR,1360,539,4,67,1970
GRR,IAH,1227,552,8,9,1796
GRR,LGA,52,16,0,0,68
GRR,MCO,833,92,4,4,933
GRR,MEM,745,97,4,13,859
GRR,MSP,2828,478,1,44,3351
GRR,ORD,5485,1240,3,231,6959
GRR,RSW,296,58,1,1,356
GRR,TPA,308,63,3,2,376
GRR,TVC,0,0,2,0,2
GSO,AEX,0,0,1,0,1
GSO,ATL,6891,1586,6,156,8639
GSO,CLT,996,134,0,19,1149
GSO,CVG,522,94,2,10,628
GSO,DFW,2462,488,32,48,3030
GSO,DTW,910,248,6,25,1189
GSO,EWR,2559,1048,9,268,3884
GSO,IAD,1677,435,1,75,2188
GSO,IAH,1151,397,7,18,1573
GSO,LGA,24,4,1,3,32
GSO,MCO,5,14,0,0,19
GSO,MEM,262,28,0,6,296
GSO,MIA,1216,181,3,17,1417
GSO,ORD,1989,600,5,72,2666
GSO,PHL,4,0,0,0,4
GSO,ROA,0,1,2,2,5
GSP,ATL,6499,1603,1,167,8270
GSP,AVL,0,1,0,1,2
GSP,BNA,610,50,0,0,660
GSP,BWI,1130,170,3,11,1314
GSP,CHS,0,0,1,0,1
GSP,CLE,773,207,1,11,992
GSP,CVG,227,30,2,4,263
GSP,DFW,3204,546,23,74,3847
GSP,DTW,961,248,5,27,1241
GSP,EWR,1690,615,8,126,2439
GSP,HOU,579,77,3,1,660
GSP,IAD,1777,486,9,88,2360
GSP,IAH,1910,381,12,15,2318
GSP,LGA,135,32,2,8,177
GSP,MCO,600,57,2,1,660
GSP,MDW,1115,139,3,5,1262
GSP,ORD,1808,484,7,82,2381
GST,JNU,180,38,0,5,223
GTF,BIL,1,0,0,0,1
GTF,DEN,2217,336,9,34,2596
GTF,FCA,0,0,1,0,1
GTF,MSP,15,3,0,0,18
GTF,SLC,2724,243,3,10,2980
GTR,ATL,1684,409,3,36,2132
GTR,MEM,380,41,1,25,447
GUC,ATL,11,1,0,1,13
GUC,DEN,1418,254,6,61,1739
GUC,DFW,330,85,0,24,439
GUC,IAH,105,21,0,4,130
GUC,SLC,41,8,1,1,51
GUM,HNL,566,170,0,5,741
GUM,SPN,8,0,0,0,8
HDN,ATL,225,62,9,6,302
HDN,DEN,2679,367,5,96,3147
HDN,DFW,291,66,0,7,364
HDN,EWR,35,15,0,2,52
HDN,IAH,279,45,2,6,332
HDN,LAX,3,1,0,0,4
HDN,LGA,2,4,1,1,8
HDN,MSP,7,4,0,2,13
HDN,ORD,350,71,0,8,429
HDN,SLC,52,9,0,2,63
HIB,INL,116,10,0,5,131
HIB,MSP,137,12,0,9,158
HLN,BIL,0,0,1,0,1
HLN,COD,0,0,1,0,1
HLN,DEN,1530,234,7,29,1800
HLN,MSO,0,1,0,0,1
HLN,MSP,62,12,0,2,76
HLN,SLC,2674,248,8,18,2948
HNL,ANC,750,176,2,0,928
HNL,ATL,900,186,2,7,1095
HNL,BLI,537,95,10,0,642
HNL,CLT,167,36,0,5,208
HNL,DEN,1112,83,3,9,1207
HNL,DFW,1736,437,9,10,2192
HNL,DTW,63,9,1,0,73
HNL,EWR,902,175,5,14,1096
HNL,GUM,488,250,0,3,741
HNL,IAD,164,29,0,2,195
HNL,IAH,1148,222,5,6,1381
HNL,ITO,17973,1330,16,75,19394
HNL,JFK,178,30,0,3,211
HNL,KOA,22444,1880,11,140,24475
HNL,LAS,2326,379,10,0,2715
HNL,LAX,13104,2424,32,85,15645
HNL,LIH,24250,1964,14,155,26383
HNL,MSP,232,44,1,5,282
HNL,OAK,1026,289,3,1,1319
HNL,OGG,32433,2519,5,203,35160
HNL,ORD,1352,315,9,11,1687
HNL,PDX,1805,329,1,2,2137
HNL,PHX,2708,544,2,30,3284
HNL,SAN,1217,322,11,3,1553
HNL,SEA,3824,899,10,8,4741
HNL,SFO,5743,1104,10,70,6927
HNL,SJC,1033,246,5,0,1284
HNL,SLC,1002,91,0,1,1094
HNL,SMF,848,247,1,0,1096
HNL,SNA,447,38,3,4,492
HOB,IAH,774,110,3,20,907
HOU,ABQ,2417,616,7,7,3047
HOU,ATL,8697,1792,28,163,10680
HOU,AUS,4095,1190,3,13,5301
HOU,BHM,1569,493,6,7,2075
HOU,BKG,388,48,2,6,444
HOU,BNA,3341,755,8,18,4122
HOU,BWI,2622,780,15,41,3458
HOU,CHS,541,118,1,0,660
HOU,CRP,3681,1124,2,99,4906
HOU,DAL,18930,4968,50,1143,25091
HOU,DEN,4253,981,19,12,5265
HOU,DFW,6287,1305,13,210,7815
HOU,ECP,1389,543,9,4,1945
HOU,ELP,2326,679,6,21,3032
HOU,EWR,730,365,5,16,1116
HOU,FLL,1633,536,6,4,2179
HOU,GSP,528,130,2,0,660
HOU,HRL,4676,1656,3,148,6483
HOU,IND,83,24,1,1,109
HOU,JAN,2236,804,9,11,3060
HOU,JAX,954,253,0,2,1209
HOU,JFK,1664,404,7,56,2131
HOU,LAS,3744,763,8,10,4525
HOU,LAX,3278,908,14,12,4212
HOU,LIT,870,212,3,11,1096
HOU,MAF,1533,417,5,10,1965
HOU,MCI,242,59,2,1,304
HOU,MCO,3472,1130,8,13,4623
HOU,MDW,4997,1298,27,54,6376
HOU,MEM,0,1,0,0,1
HOU,MSY,7922,2029,18,74,10043
HOU,OAK,1568,511,1,5,2085
HOU,OKC,2856,933,6,30,3825
HOU,PHL,944,461,12,19,1436
HOU,PHX,3290,813,5,14,4122
HOU,RDU,214,39,1,0,254
HOU,SAN,1636,481,9,7,2133
HOU,SAT,4001,1284,4,26,5315
HOU,SEA,49,21,0,0,70
HOU,SNA,47,11,0,0,58
HOU,STL,3065,849,5,18,3937
HOU,TPA,3099,981,8,11,4099
HOU,TUL,2542,752,6,29,3329
HPN,ATL,5540,1569,18,222,7349
HPN,BUF,0,1,0,0,1
HPN,CVG,51,2,0,0,53
HPN,DTW,30,2,0,3,35
HPN,FLL,2350,641,13,77,3081
HPN,MCO,4108,992,10,109,5219
HPN,MLI,1,0,0,0,1
HPN,ORD,3953,930,8,246,5137
HPN,PBI,3519,928,16,86,4549
HPN,RSW,1317,282,6,38,1643
HPN,TPA,902,171,0,23,1096
HRL,AUS,902,177,0,3,1082
HRL,DAL,104,5,0,0,109
HRL,HOU,5472,846,9,150,6477
HRL,IAH,4207,573,5,85,4870
HRL,SAT,1603,231,2,13,1849
HSV,ATL,7601,1721,5,203,9530
HSV,BHM,1,0,0,0,1
HSV,BNA,1,1,0,0,2
HSV,BWI,1442,148,5,13,1608
HSV,CLT,116,12,0,2,130
HSV,CVG,2,1,0,0,3
HSV,DCA,355,82,1,24,462
HSV,DEN,1634,249,9,27,1919
HSV,DFW,2670,328,12,88,3098
HSV,DTW,833,168,4,17,1022
HSV,IAD,1447,289,3,76,1815
HSV,IAH,2239,563,3,44,2849
HSV,MCO,742,60,2,5,809
HSV,MEM,1497,232,3,50,1782
HSV,ORD,2961,692,6,157,3816
HTS,CVG,249,16,1,10,276
IAD,ABE,212,46,0,18,276
IAD,ABQ,815,257,2,20,1094
IAD,ALB,1620,416,3,73,2112
IAD,ATL,11208,2402,28,367,14005
IAD,AUS,1347,283,5,31,1666
IAD,BDL,2937,620,2,106,3665
IAD,BNA,1889,468,6,55,2418
IAD,BOS,8042,2132,5,249,10428
IAD,BTV,1253,306,8,52,1619
IAD,BUF,2821,679,3,98,3601
IAD,CAE,2829,798,7,118,3752
IAD,CHO,0,0,1,0,1
IAD,CHS,2525,660,15,92,3292
IAD,CLE,2617,638,4,87,3346
IAD,CLT,6232,1367,15,214,7828
IAD,CMH,1492,320,2,60,1874
IAD,COS,629,274,8,23,934
IAD,CRW,353,90,1,20,464
IAD,CVG,1741,390,2,70,2203
IAD,DAY,1988,488,4,93,2573
IAD,DCA,0,1,0,0,1
IAD,DEN,8695,1762,31,173,10661
IAD,DFW,6151,1061,40,237,7489
IAD,DTW,3312,901,10,119,4342
IAD,EWR,1840,906,3,142,2891
IAD,FLL,1560,308,4,18,1890
IAD,GSO,1687,481,4,65,2237
IAD,GSP,1813,447,4,72,2336
IAD,HNL,167,21,2,4,194
IAD,HSV,1457,335,6,65,1863
IAD,IAH,4258,1190,34,99,5581
IAD,IND,1845,361,4,44,2254
IAD,JAX,1822,449,3,31,2305
IAD,JFK,5071,1553,4,311,6939
IAD,LAS,2250,443,8,30,2731
IAD,LAX,10035,2444,27,217,12723
IAD,LGA,3479,1330,17,314,5140
IAD,LGB,1236,308,3,14,1561
IAD,MCI,1373,311,10,29,1723
IAD,MCO,6135,1472,11,98,7716
IAD,MDW,5244,792,22,91,6149
IAD,MHT,1245,328,1,47,1621
IAD,MIA,3066,585,11,47,3709
IAD,MSP,186,20,0,1,207
IAD,MSY,943,201,3,13,1160
IAD,OAK,566,251,0,14,831
IAD,OKC,336,86,1,7,430
IAD,ORD,6230,1286,8,232,7756
IAD,ORF,2247,515,2,71,2835
IAD,PDX,799,301,3,17,1120
IAD,PHL,1,0,0,0,1
IAD,PHX,843,277,3,11,1134
IAD,PIT,1563,365,2,53,1983
IAD,PNS,1122,420,8,33,1583
IAD,PVD,1603,301,5,54,1963
IAD,PWM,1231,328,4,46,1609
IAD,RDU,3604,632,4,92,4332
IAD,RIC,1259,412,4,45,1720
IAD,ROA,1294,339,5,97,1735
IAD,ROC,1964,437,8,59,2468
IAD,SAN,2715,613,16,35,3379
IAD,SAT,938,169,7,10,1124
IAD,SAV,2390,611,7,69,3077
IAD,SDF,392,234,2,19,647
IAD,SEA,2736,554,10,38,3338
IAD,SFO,8669,2324,36,171,11200
IAD,SJU,1342,300,5,19,1666
IAD,SLC,1125,316,3,20,1464
IAD,SMF,801,273,4,17,1095
IAD,STL,331,73,1,5,410
IAD,STT,259,49,1,2,311
IAD,SYR,1299,285,2,30,1616
IAD,TPA,2727,618,6,45,3396
IAD,TUL,285,138,4,5,432
IAD,TYS,1969,598,4,79,2650
IAH,ABQ,4154,1144,12,45,5355
IAH,ACT,143,37,0,7,187
IAH,AEX,1958,444,9,50,2461
IAH,AGS,2,1,0,0,3
IAH,AMA,3143,730,16,83,3972
IAH,ANC,209,152,6,0,367
IAH,ASE,309,92,18,11,430
IAH,ATL,11769,3340,50,205,15364
IAH,AUS,8426,1785,9,56,10276
IAH,AVL,726,194,5,14,939
IAH,BFL,979,182,1,3,1165
IAH,BHM,4545,1445,17,76,6083
IAH,BNA,4768,1373,16,39,6196
IAH,BOS,4029,1165,13,51,5258
IAH,BPT,12,4,0,0,16
IAH,BRO,3965,942,22,74,5003
IAH,BTR,4926,1280,18,101,6325
IAH,BWI,3275,657,15,48,3995
IAH,CAE,1203,318,9,19,1549
IAH,CHS,1827,680,16,17,2540
IAH,CID,608,281,4,9,902
IAH,CLE,5378,927,1,27,6333
IAH,CLL,620,108,0,20,748
IAH,CLT,11438,2538,22,118,14116
IAH,CMH,2948,793,15,23,3779
IAH,COS,3607,1057,29,36,4729
IAH,CRP,7501,1701,12,118,9332
IAH,CRW,811,238,11,19,1079
IAH,CVG,3959,1112,10,62,5143
IAH,DAL,4393,1165,8,113,5679
IAH,DAY,786,354,5,9,1154
IAH,DCA,6674,1279,25,116,8094
IAH,DEN,9683,2263,25,53,12024
IAH,DFW,11026,2610,31,220,13887
IAH,DRT,317,48,1,6,372
IAH,DSM,1284,631,5,27,1947
IAH,DTW,5990,1288,25,70,7373
IAH,EGE,254,62,7,4,327
IAH,ELP,4686,1328,9,49,6072
IAH,EWR,9102,2495,57,158,11812
IAH,FLL,4311,897,10,8,5226
IAH,GJT,707,166,4,5,882
IAH,GPT,3718,1008,19,94,4839
IAH,GRK,769,105,1,9,884
IAH,GRR,1291,494,10,7,1802
IAH,GSO,1212,351,8,12,1583
IAH,GSP,1747,549,9,12,2317
IAH,GUC,99,25,4,2,130
IAH,HDN,278,44,9,1,332
IAH,HNL,1071,300,2,4,1377
IAH,HOB,634,248,6,20,908
IAH,HRL,3836,940,8,84,4868
IAH,HSV,2120,684,8,34,2846
IAH,IAD,4199,1273,18,70,5560
IAH,ICT,3528,992,17,63,4600
IAH,IND,4128,1025,14,33,5200
IAH,JAC,13,9,1,1,24
IAH,JAN,2999,797,17,67,3880
IAH,JAX,3833,1140,11,23,5007
IAH,JFK,212,45,0,18,275
IAH,LAS,6450,1232,11,17,7710
IAH,LAX,10014,3395,17,57,13483
IAH,LBB,3029,768,24,79,3900
IAH,LCH,1306,234,1,42,1583
IAH,LEX,1188,423,7,16,1634
IAH,LFT,5480,1306,39,168,6993
IAH,LGA,6221,1945,58,153,8377
IAH,LIT,3606,961,10,73,4650
IAH,LRD,2661,714,11,47,3433
IAH,MAF,4539,1196,16,103,5854
IAH,MCI,6947,2189,43,85,9264
IAH,MCO,5196,1237,12,14,6459
IAH,MEM,6032,1402,13,124,7571
IAH,MFE,4055,1038,7,46,5146
IAH,MIA,6585,1062,25,85,7757
IAH,MKE,3216,1123,25,31,4395
IAH,MLU,948,229,8,23,1208
IAH,MOB,3956,1034,10,88,5088
IAH,MSP,4888,1415,22,66,6391
IAH,MSY,9067,1741,8,89,10905
IAH,MTJ,443,68,1,2,514
IAH,MYR,1,0,0,0,1
IAH,OKC,4859,1249,15,101,6224
IAH,OMA,4666,1233,13,35,5947
IAH,ONT,2300,456,4,4,2764
IAH,ORD,12629,4051,44,219,16943
IAH,ORF,1359,511,4,19,1893
IAH,PBI,2706,626,9,20,3361
IAH,PDX,2750,890,10,7,3657
IAH,PHL,4946,1309,19,84,6358
IAH,PHX,9085,1630,16,54,10785
IAH,PIT,3991,964,12,35,5002
IAH,PNS,3572,1048,18,62,4700
IAH,PSP,296,110,1,0,407
IAH,RAP,71,11,0,0,82
IAH,RDU,4056,1054,16,23,5149
IAH,RIC,1934,686,2,17,2639
IAH,RNO,332,52,1,1,386
IAH,RSW,2116,544,4,12,2676
IAH,SAN,5511,1135,20,21,6687
IAH,SAT,8030,1809,6,57,9902
IAH,SAV,1741,604,10,19,2374
IAH,SDF,2544,721,7,15,3287
IAH,SEA,5780,1992,14,11,7797
IAH,SFO,6190,2587,15,43,8835
IAH,SHV,2298,631,5,44,2978
IAH,SJC,2204,393,2,4,2603
IAH,SJU,900,283,1,4,1188
IAH,SLC,5054,968,5,27,6054
IAH,SMF,2522,513,5,4,3044
IAH,SNA,4218,710,12,21,4961
IAH,STL,2080,585,12,22,2699
IAH,TPA,4283,871,7,13,5174
IAH,TUL,5580,1278,15,101,6974
IAH,TUS,3442,1073,13,26,4554
IAH,TYR,458,81,1,16,556
IAH,TYS,2521,822,8,13,3364
IAH,VPS,2066,724,20,32,2842
IAH,XNA,2685,749,18,61,3513
ICT,ATL,5975,1024,15,104,7118
ICT,DEN,3861,637,11,57,4566
ICT,DFW,3510,537,16,105,4168
ICT,DTW,215,35,1,4,255
ICT,IAH,3724,791,13,71,4599
ICT,MCO,13,1,0,0,14
ICT,MEM,1071,233,4,20,1328
ICT,MKE,0,1,0,0,1
ICT,MSP,2155,229,1,31,2416
ICT,ORD,6863,1654,18,279,8814
ICT,TUL,0,0,0,1,1
IDA,BOI,0,1,0,0,1
IDA,DEN,2528,396,10,56,2990
IDA,PIH,1,0,0,0,1
IDA,SFO,394,80,0,10,484
IDA,SLC,4896,414,2,64,5376
ILM,ATL,5369,1142,14,109,6634
ILM,CLT,3873,457,4,55,4389
ILM,MYR,0,0,1,0,1
ILM,OAJ,0,0,1,0,1
ILM,ORD,469,63,1,13,546
IMT,ESC,109,14,0,8,131
IMT,MSP,28,1,0,1,30
IND,ATL,9601,1841,25,146,11613
IND,BKG,26,2,0,2,30
IND,BOS,820,256,8,45,1129
IND,BWI,3400,636,9,56,4101
IND,CLE,1319,214,1,11,1545
IND,CLT,1967,299,1,36,2303
IND,CVG,478,77,1,13,569
IND,DCA,503,119,1,38,661
IND,DEN,5312,1034,16,27,6389
IND,DFW,4476,742,22,94,5334
IND,DTW,3231,693,5,57,3986
IND,EWR,2747,1540,17,175,4479
IND,FLL,696,117,3,6,822
IND,HOU,97,11,0,1,109
IND,IAD,1782,395,5,60,2242
IND,IAH,3830,1050,13,44,4937
IND,ISP,2,0,0,0,2
IND,JFK,1016,460,8,83,1567
IND,LAS,2699,358,4,9,3070
IND,LAX,497,162,2,3,664
IND,LGA,1278,324,16,81,1699
IND,MCI,1781,234,4,10,2029
IND,MCO,4295,572,6,17,4890
IND,MDW,2975,500,5,22,3502
IND,MEM,879,222,4,23,1128
IND,MIA,1494,507,5,31,2037
IND,MKE,1315,297,3,39,1654
IND,MSP,2887,507,3,38,3435
IND,OMA,0,1,0,0,1
IND,ORD,5481,1674,7,261,7423
IND,PHL,264,29,0,6,299
IND,PHX,3553,433,10,36,4032
IND,PVD,1,0,0,1,2
IND,RDU,440,132,3,10,585
IND,RSW,2264,295,12,13,2584
IND,SFO,2,1,0,0,3
IND,SLC,958,102,0,6,1066
IND,SRQ,364,47,2,0,413
IND,TPA,3216,351,9,16,3592
INL,BRD,4,6,0,0,10
INL,HIB,109,14,2,6,131
INL,MSP,15,1,0,0,16
IPL,LAX,1488,249,3,26,1766
IPL,YUM,395,7,0,9,411
ISN,DEN,87,70,0,10,167
ISN,MSP,37,52,0,3,92
ISP,BWI,4761,782,11,120,5674
ISP,FLL,2172,308,8,47,2535
ISP,IND,2,0,0,0,2
ISP,LAS,265,23,0,5,293
ISP,MCO,4059,621,4,75,4759
ISP,MDW,2413,244,9,59,2725
ISP,PBI,2308,414,5,42,2769
ISP,RSW,168,21,1,1,191
ISP,TPA,2087,300,9,43,2439
ITH,DTW,736,160,2,49,947
ITO,HNL,17871,1427,7,89,19394
ITO,KOA,1,0,0,0,1
ITO,LAX,503,41,2,1,547
ITO,OGG,1354,37,0,1,1392
ITO,SFO,49,13,0,0,62
IYK,LAX,2369,162,9,111,2651
JAC,ATL,125,34,4,6,169
JAC,DEN,3289,588,6,80,3963
JAC,DFW,518,94,6,7,625
JAC,EWR,3,10,0,0,13
JAC,IAH,16,7,0,1,24
JAC,LAX,364,51,0,19,434
JAC,MSP,161,15,0,0,176
JAC,ORD,670,199,5,26,900
JAC,SFO,50,17,0,3,70
JAC,SLC,2910,552,2,81,3545
JAN,ATL,6329,1863,7,174,8373
JAN,BTR,0,0,1,0,1
JAN,BWI,1213,265,6,24,1508
JAN,DCA,458,72,1,32,563
JAN,DFW,6693,1344,27,212,8276
JAN,DTW,468,108,5,21,602
JAN,HOU,2588,449,7,15,3059
JAN,IAH,3018,778,10,73,3879
JAN,MCO,883,159,1,4,1047
JAN,MDW,1320,213,4,14,1551
JAN,MEM,2320,314,0,50,2684
JAN,ORD,31,24,1,2,58
JAX,ABE,0,0,1,0,1
JAX,ATL,14231,2251,14,181,16677
JAX,BHM,929,149,9,0,1087
JAX,BNA,3197,506,6,14,3723
JAX,BOS,1211,288,3,17,1519
JAX,BWI,3534,629,16,39,4218
JAX,CLE,152,29,0,2,183
JAX,CLT,6592,758,15,61,7426
JAX,CVG,311,37,3,7,358
JAX,DCA,1148,183,4,27,1362
JAX,DEN,541,33,1,1,576
JAX,DFW,3517,517,26,61,4121
JAX,DTW,1430,255,4,31,1720
JAX,EWR,2357,1118,17,119,3611
JAX,FLL,3621,561,6,20,4208
JAX,GPT,2,0,0,0,2
JAX,HOU,988,205,6,0,1199
JAX,IAD,2140,421,7,49,2617
JAX,IAH,4010,927,19,31,4987
JAX,JFK,2448,557,8,77,3090
JAX,LAS,915,128,3,0,1046
JAX,LGA,1021,193,7,66,1287
JAX,MEM,1741,299,6,42,2088
JAX,MIA,1426,397,3,48,1874
JAX,MSP,107,11,0,1,119
JAX,ORD,3729,811,21,95,4656
JAX,ORF,1700,231,8,10,1949
JAX,PHL,2381,371,10,41,2803
JAX,SJU,465,114,2,1,582
JAX,TPA,2104,252,1,4,2361
JFK,ACK,680,140,3,21,844
JFK,ALB,235,72,0,28,335
JFK,ATL,5432,1082,11,101,6626
JFK,AUS,2750,827,5,80,3662
JFK,BDL,185,57,0,20,262
JFK,BGR,138,37,0,15,190
JFK,BNA,924,230,1,55,1210
JFK,BOS,11585,3351,6,539,15481
JFK,BQN,1689,341,3,41,2074
JFK,BTV,3953,1135,9,168,5265
JFK,BUF,7269,2021,3,258,9551
JFK,BUR,1823,533,17,37,2410
JFK,BWI,978,266,1,105,1350
JFK,CLE,1479,401,2,140,2022
JFK,CLT,4899,1425,7,172,6503
JFK,CMH,1493,500,1,107,2101
JFK,CVG,1510,422,3,108,2043
JFK,DCA,6010,1565,13,494,8082
JFK,DEN,1603,537,4,41,2185
JFK,DFW,1041,427,11,60,1539
JFK,DTW,1716,605,5,86,2412
JFK,EGE,235,80,7,9,331
JFK,FLL,9622,3028,26,257,12933
JFK,HNL,197,9,1,3,210
JFK,HOU,1564,514,7,47,2132
JFK,IAD,5292,1326,4,334,6956
JFK,IAH,173,77,6,25,281
JFK,IND,1095,360,8,79,1542
JFK,JAX,2287,734,4,70,3095
JFK,LAS,9134,2166,23,189,11512
JFK,LAX,24836,5015,67,493,30411
JFK,LGB,1736,434,17,37,2224
JFK,LWB,44,10,0,8,62
JFK,MCI,134,87,3,18,242
JFK,MCO,12481,3567,26,307,16381
JFK,MEM,32,63,0,4,99
JFK,MIA,9337,1985,38,289,11649
JFK,MKE,1,2,0,0,3
JFK,MSP,1422,364,3,56,1845
JFK,MSY,2276,632,4,67,2979
JFK,MVY,181,35,2,3,221
JFK,OAK,899,419,15,23,1356
JFK,ORD,3584,1554,18,215,5371
JFK,ORF,1079,242,3,113,1437
JFK,PBI,4582,1377,9,114,6082
JFK,PDX,1552,626,8,32,2218
JFK,PHL,182,42,0,24,248
JFK,PHX,4934,1141,11,116,6202
JFK,PIT,3624,1100,6,199,4929
JFK,PSE,824,245,7,29,1105
JFK,PSP,1,1,0,0,2
JFK,PWM,3045,855,4,140,4044
JFK,RDU,6645,1812,9,297,8763
JFK,RIC,1006,284,2,80,1372
JFK,ROC,3992,1110,6,171,5279
JFK,RSW,3118,917,4,83,4122
JFK,SAN,4025,949,28,94,5096
JFK,SAT,536,186,1,13,736
JFK,SEA,4530,1169,11,80,5790
JFK,SFO,16941,4598,80,439,22058
JFK,SJC,778,233,12,17,1040
JFK,SJU,9245,2732,22,204,12203
JFK,SLC,4570,949,16,78,5613
JFK,SMF,598,292,2,11,903
JFK,SNA,92,5,0,1,98
JFK,SRQ,1382,289,1,36,1708
JFK,STL,674,214,3,62,953
JFK,STT,794,252,6,11,1063
JFK,SYR,3835,1135,0,154,5124
JFK,TPA,5462,1768,14,161,7405
JLN,DFW,570,87,0,13,670
JNU,ANC,2763,512,11,78,3364
JNU,GST,198,20,0,5,223
JNU,KTN,978,71,14,27,1090
JNU,PSG,857,199,12,20,1088
JNU,SEA,2851,387,12,50,3300
JNU,SIT,2041,332,15,53,2441
JNU,YAK,868,187,11,19,1085
KOA,ANC,7,1,0,0,8
KOA,DEN,159,24,1,1,185
KOA,HNL,22426,1891,4,156,24477
KOA,LAX,3393,415,25,31,3864
KOA,OAK,535,96,5,2,638
KOA,OGG,2489,106,0,4,2599
KOA,ORD,96,25,0,0,121
KOA,PDX,170,39,0,0,209
KOA,PHX,894,79,2,10,985
KOA,SEA,1035,208,6,1,1250
KOA,SFO,1612,269,17,18,1916
KOA,SJC,444,63,2,2,511
KTN,JNU,894,158,4,33,1089
KTN,SEA,3397,386,2,73,3858
KTN,SIT,891,182,9,9,1091
KTN,WRG,893,177,8,7,1085
LAN,CLE,1,1,0,0,2
LAN,DTW,1755,295,2,48,2100
LAN,MSP,312,45,1,14,372
LAN,ORD,2756,696,1,194,3647
LAN,TVC,0,0,1,0,1
LAR,DEN,99,6,0,9,114
LAS,ABQ,4609,1147,4,12,5772
LAS,ALB,847,244,2,3,1096
LAS,AMA,907,186,2,1,1096
LAS,ATL,10863,1776,44,62,12745
LAS,AUS,2647,611,6,3,3267
LAS,BDL,768,227,2,7,1004
LAS,BHM,887,205,3,0,1095
LAS,BLI,924,82,1,1,1008
LAS,BNA,2308,582,8,4,2902
LAS,BOI,1794,393,0,0,2187
LAS,BOS,1867,466,3,24,2360
LAS,BUF,1515,372,4,3,1894
LAS,BUR,10696,2050,32,143,12921
LAS,BWI,2755,828,10,40,3633
LAS,CLE,3377,604,10,11,4002
LAS,CLT,4312,834,16,30,5192
LAS,CMH,1732,445,12,2,2191
LAS,CVG,1475,160,0,13,1648
LAS,DCA,919,141,10,13,1083
LAS,DEN,19191,3410,22,115,22738
LAS,DFW,10991,2064,58,188,13301
LAS,DTW,5146,828,18,21,6013
LAS,ELP,2582,673,2,4,3261
LAS,EWR,4798,1480,40,94,6412
LAS,FAT,3720,1018,8,111,4857
LAS,FLL,997,318,6,4,1325
LAS,GEG,1714,472,2,0,2188
LAS,HNL,2217,490,8,0,2715
LAS,HOU,3505,980,13,11,4509
LAS,IAD,2651,436,9,37,3133
LAS,IAH,6760,941,22,19,7742
LAS,IND,2521,531,8,8,3068
LAS,ISP,215,73,1,4,293
LAS,JAX,827,217,1,0,1045
LAS,JFK,9193,2059,65,195,11512
LAS,LAX,26478,6273,17,253,33021
LAS,LBB,906,189,6,2,1103
LAS,LGA,1,0,0,0,1
LAS,LGB,3741,589,2,20,4352
LAS,LIT,930,161,3,2,1096
LAS,MAF,967,176,3,1,1147
LAS,MCI,3506,837,12,13,4368
LAS,MCO,1819,520,7,1,2347
LAS,MDW,7733,1679,40,114,9566
LAS,MEM,2300,197,6,13,2516
LAS,MHT,676,176,4,5,861
LAS,MIA,2698,603,13,21,3335
LAS,MKE,4783,845,9,24,5661
LAS,MSP,5582,859,12,54,6507
LAS,MSY,1658,443,4,6,2111
LAS,OAK,7136,1852,1,38,9027
LAS,OGG,171,28,0,0,199
LAS,OKC,1563,360,7,5,1935
LAS,OMA,2314,503,4,4,2825
LAS,ONT,6089,1472,4,20,7585
LAS,ORD,9221,1785,35,119,11160
LAS,ORF,387,123,2,2,514
LAS,PDX,6666,1024,5,10,7705
LAS,PHL,5190,1176,42,81,6489
LAS,PHX,21381,3751,14,428,25574
LAS,PIT,1844,448,4,11,2307
LAS,PSP,2331,604,2,72,3009
LAS,PVD,843,237,2,8,1090
LAS,RDU,903,187,4,1,1095
LAS,RNO,8749,1994,11,36,10790
LAS,SAN,10091,2295,16,108,12510
LAS,SAT,3429,871,11,2,4313
LAS,SDF,843,250,3,0,1096
LAS,SEA,11224,1362,4,33,12623
LAS,SFO,15159,5687,14,188,21048
LAS,SJC,7301,1588,6,51,8946
LAS,SLC,11763,2344,11,53,14171
LAS,SMF,6680,1610,5,13,8308
LAS,SNA,6695,1148,4,55,7902
LAS,STL,3236,789,9,14,4048
LAS,TPA,1570,391,6,0,1967
LAS,TUL,893,228,4,1,1126
LAS,TUS,4196,1017,3,12,5228
LAW,DFW,1513,167,0,46,1726
LAX,ABQ,7096,1435,22,41,8594
LAX,ANC,505,76,1,0,582
LAX,ASE,1296,244,82,40,1662
LAX,ATL,12019,2805,41,71,14936
LAX,AUS,5162,1056,8,31,6257
LAX,BDL,49,28,0,0,77
LAX,BFL,1805,286,1,28,2120
LAX,BHM,1,0,0,0,1
LAX,BNA,2802,551,7,14,3374
LAX,BOI,2066,358,7,10,2441
LAX,BOS,6461,1791,19,86,8357
LAX,BWI,2731,672,17,24,3444
LAX,BZN,209,57,0,3,269
LAX,CLD,5121,1066,10,123,6320
LAX,CLE,2235,714,2,5,2956
LAX,CLT,3850,904,8,27,4789
LAX,CMH,346,81,1,0,428
LAX,COS,2474,570,13,21,3078
LAX,CVG,2283,334,6,17,2640
LAX,DCA,1044,228,3,20,1295
LAX,DEN,20720,4400,38,191,25349
LAX,DFW,18515,3625,108,357,22605
LAX,DTW,5028,1021,19,20,6088
LAX,EGE,254,67,4,9,334
LAX,ELP,4567,1149,9,26,5751
LAX,EUG,1,1,0,0,2
LAX,EWR,5828,2478,48,170,8524
LAX,FAT,9672,1855,15,123,11665
LAX,FLL,1796,560,8,10,2374
LAX,GJT,0,0,0,1,1
LAX,HDN,4,0,0,0,4
LAX,HNL,12173,3398,22,58,15651
LAX,HOU,3234,977,18,22,4251
LAX,IAD,9575,2057,28,205,11865
LAX,IAH,10482,2874,27,71,13454
LAX,IND,534,123,1,4,662
LAX,IPL,1448,285,2,21,1756
LAX,ITO,415,131,0,1,547
LAX,IYK,2276,273,3,99,2651
LAX,JAC,334,82,4,12,432
LAX,JFK,24406,5357,140,489,30392
LAX,KOA,3224,623,6,12,3865
LAX,LAS,26560,6708,10,276,33554
LAX,LIH,3438,769,10,3,4220
LAX,MCI,2260,498,7,10,2775
LAX,MCO,4927,948,25,11,5911
LAX,MDW,5156,1077,31,56,6320
LAX,MEM,2545,300,7,20,2872
LAX,MIA,6719,1709,33,60,8521
LAX,MKE,2014,451,7,15,2487
LAX,MRY,5774,828,72,83,6757
LAX,MSP,5931,1071,13,37,7052
LAX,MSY,3020,665,8,20,3713
LAX,MTJ,78,15,0,1,94
LAX,OAK,13047,3042,5,486,16580
LAX,OGG,6485,1447,14,26,7972
LAX,OKC,2049,441,5,16,2511
LAX,ORD,19042,4399,50,338,23829
LAX,OXR,399,44,0,8,451
LAX,PDX,8030,1135,8,20,9193
LAX,PHL,6142,1225,18,69,7454
LAX,PHX,22501,4451,17,400,27369
LAX,PIT,832,124,1,6,963
LAX,PSP,5174,1134,7,38,6353
LAX,RDU,252,90,0,1,343
LAX,RNO,6805,1122,16,25,7968
LAX,ROW,179,21,0,0,200
LAX,SAF,963,117,4,9,1093
LAX,SAN,27184,4654,24,521,32383
LAX,SAT,4163,819,15,18,5015
LAX,SBA,11784,1841,14,173,13812
LAX,SBP,4990,900,9,80,5979
LAX,SEA,14533,1791,9,51,16384
LAX,SFO,29555,12403,36,1094,43088
LAX,SGU,393,175,2,1,571
LAX,SJC,16112,3017,18,263,19410
LAX,SJU,213,53,0,0,266
LAX,SLC,12568,2727,19,63,15377
LAX,SMF,14255,2697,15,115,17082
LAX,SMX,3481,517,20,119,4137
LAX,SNA,0,0,0,1,1
LAX,STL,4072,858,18,42,4990
LAX,TPA,794,233,5,1,1033
LAX,TUL,700,142,3,10,855
LAX,TUS,8482,1970,13,54,10519
LAX,YUM,3428,701,2,36,4167
LBB,ABQ,896,50,1,7,954
LBB,AUS,1641,248,1,16,1906
LBB,DAL,5275,779,11,95,6160
LBB,DEN,1015,145,2,26,1188
LBB,DFW,5799,1234,5,236,7274
LBB,IAH,3264,541,8,87,3900
LBB,LAS,914,184,1,5,1104
LBB,MEM,809,86,2,23,920
LBB,ORD,0,0,0,1,1
LBB,SHV,0,1,0,0,1
LCH,DFW,1886,246,3,51,2186
LCH,IAH,1394,143,0,47,1584
LEX,ATL,6102,1567,11,136,7816
LEX,CRW,1,0,0,0,1
LEX,CVG,499,61,0,11,571
LEX,DCA,250,49,0,16,315
LEX,DFW,2591,470,17,63,3141
LEX,DTW,1511,319,0,28,1858
LEX,EWR,8,1,0,0,9
LEX,FLL,150,32,0,0,182
LEX,HSV,1,0,0,0,1
LEX,IAH,1244,366,5,20,1635
LEX,LGA,115,48,3,15,181
LEX,MCO,577,74,1,0,652
LEX,MEM,718,119,4,20,861
LEX,MSP,261,72,0,16,349
LEX,ORD,4876,1032,7,225,6140
LEX,TYS,0,1,1,0,2
LFT,ATL,3242,768,14,79,4103
LFT,DFW,3144,535,13,120,3812
LFT,IAH,5702,1102,11,180,6995
LFT,MEM,1116,165,0,35,1316
LGA,AGS,5,4,0,0,9
LGA,ATL,23624,6658,52,1133,31467
LGA,AVL,33,11,0,1,45
LGA,BDL,1,0,0,0,1
LGA,BGR,152,45,0,17,214
LGA,BHM,388,115,0,48,551
LGA,BNA,4161,929,3,191,5284
LGA,BOS,22319,3840,5,2010,28174
LGA,BTV,4,1,0,0,5
LGA,BUF,249,69,0,9,327
LGA,BWI,2487,691,4,74,3256
LGA,CAE,67,30,0,11,108
LGA,CAK,2071,613,4,58,2746
LGA,CHS,367,115,3,29,514
LGA,CLE,5320,1413,12,344,7089
LGA,CLT,10902,2497,20,430,13849
LGA,CMH,4283,999,7,280,5569
LGA,CRW,666,233,2,36,937
LGA,CVG,2045,456,4,109,2614
LGA,DCA,11516,2052,12,912,14492
LGA,DEN,6236,1474,41,176,7927
LGA,DFW,12088,2370,188,628,15274
LGA,DTW,11081,2592,17,578,14268
LGA,EGE,36,7,3,0,46
LGA,EYW,2,0,0,0,2
LGA,FLL,8376,2885,24,298,11583
LGA,GRR,20,11,0,4,35
LGA,GSO,20,9,0,3,32
LGA,GSP,97,58,0,20,175
LGA,HDN,6,1,0,1,8
LGA,IAD,3763,1067,1,338,5169
LGA,IAH,6598,1574,16,170,8358
LGA,IND,1192,355,2,86,1635
LGA,JAX,948,278,2,60,1288
LGA,LAS,0,1,0,0,1
LGA,LEX,134,41,0,17,192
LGA,LWB,99,33,0,10,142
LGA,MCI,524,190,3,53,770
LGA,MCO,7043,2255,13,229,9540
LGA,MDW,3978,1201,14,125,5318
LGA,MEM,2545,477,2,78,3102
LGA,MHT,4,3,0,0,7
LGA,MIA,9224,2307,40,318,11889
LGA,MKE,4550,1329,11,165,6055
LGA,MSN,116,34,1,8,159
LGA,MSP,8097,1944,18,330,10389
LGA,MSY,2401,519,2,91,3013
LGA,MYR,59,35,0,4,98
LGA,OMA,92,38,0,17,147
LGA,ORD,23094,5495,70,1482,30141
LGA,ORF,295,124,0,20,439
LGA,PBI,4491,1418,13,174,6096
LGA,PHF,1110,367,4,38,1519
LGA,PHL,971,91,2,25,1089
LGA,PHX,22,3,1,0,26
LGA,PIT,197,54,1,20,272
LGA,PWM,499,216,2,42,759
LGA,RDU,8469,1909,12,535,10925
LGA,RIC,216,82,0,16,314
LGA,ROC,47,9,0,1,57
LGA,RSW,1419,309,3,51,1782
LGA,SAV,345,124,0,36,505
LGA,SDF,2,3,0,0,5
LGA,SLC,19,2,0,0,21
LGA,SRQ,131,87,2,4,224
LGA,STL,3416,743,9,151,4319
LGA,SYR,38,10,0,7,55
LGA,TPA,3433,938,9,116,4496
LGA,TVC,89,25,2,7,123
LGA,TYS,317,139,1,55,512
LGA,XNA,1786,398,35,101,2320
LGB,ANC,158,51,0,0,209
LGB,AUS,932,154,0,1,1087
LGB,BOS,728,306,1,12,1047
LGB,BUR,2,0,0,0,2
LGB,DEN,42,2,0,2,46
LGB,FAT,1,0,0,0,1
LGB,FLL,359,110,1,0,470
LGB,IAD,1176,363,3,17,1559
LGB,JFK,1633,542,10,39,2224
LGB,LAS,3549,791,0,12,4352
LGB,OAK,3255,606,4,15,3880
LGB,ORD,661,222,4,9,896
LGB,PDX,2516,416,2,15,2949
LGB,PHX,4459,337,3,58,4857
LGB,SEA,4164,553,4,33,4754
LGB,SFO,2942,996,8,44,3990
LGB,SJC,10,2,0,0,12
LGB,SLC,6732,888,5,47,7672
LGB,SMF,2181,344,4,8,2537
LIH,DEN,131,16,0,0,147
LIH,HNL,23232,2178,1,176,25587
LIH,LAX,3636,536,22,26,4220
LIH,OAK,456,40,0,0,496
LIH,OGG,1671,149,1,14,1835
LIH,PDX,28,4,0,0,32
LIH,PHX,892,47,6,15,960
LIH,SEA,953,165,4,0,1122
LIH,SFO,1009,153,7,21,1190
LIH,SJC,398,45,1,2,446
LIT,ATL,6546,1459,14,177,8196
LIT,BWI,942,138,4,12,1096
LIT,CLT,1267,157,1,12,1437
LIT,CVG,9,2,0,1,12
LIT,DAL,5016,953,16,66,6051
LIT,DEN,2535,617,18,61,3231
LIT,DFW,7031,1571,22,264,8888
LIT,DTW,633,102,0,18,753
LIT,EWR,623,77,5,20,725
LIT,HOU,902,184,3,7,1096
LIT,IAH,3530,1029,9,81,4649
LIT,LAS,933,157,3,3,1096
LIT,MDW,1002,88,5,6,1101
LIT,MEM,2279,331,2,52,2664
LIT,MSP,53,13,0,0,66
LIT,OKC,0,1,0,0,1
LIT,ORD,6481,1781,19,304,8585
LIT,PHX,1043,49,1,2,1095
LIT,PIT,0,2,0,1,3
LIT,STL,1654,294,6,9,1963
LIT,XNA,0,1,0,1,2
LMT,PDX,1134,205,2,26,1367
LMT,SFO,1427,422,3,63,1915
LNK,DEN,2503,447,9,55,3014
LNK,HPN,2,0,0,0,2
LNK,MEM,15,6,0,1,22
LNK,MSP,1031,141,0,18,1190
LNK,ORD,3075,819,4,134,4032
LRD,DFW,3482,618,14,99,4213
LRD,IAH,2964,412,8,51,3435
LSE,DTW,364,59,0,5,428
LSE,MSP,2509,284,3,77,2873
LSE,ORD,1222,288,7,61,1578
LWB,ATL,493,152,1,15,661
LWB,JFK,42,10,0,10,62
LWB,LGA,92,35,0,15,142
LWB,ROA,185,21,3,11,220
LWS,SLC,1955,119,3,11,2088
LYH,ATL,787,126,4,27,944
LYH,ROA,0,0,1,0,1
MAF,ABQ,904,45,1,4,954
MAF,DAL,4930,672,15,73,5690
MAF,DEN,1837,312,1,31,2181
MAF,DFW,3987,751,19,109,4866
MAF,HOU,1700,313,5,8,2026
MAF,IAH,4856,874,13,113,5856
MAF,LAS,987,157,2,1,1147
MBS,DLH,0,1,0,0,1
MBS,DTW,2134,405,0,61,2600
MBS,MSP,354,62,0,7,423
MBS,ORD,2467,579,0,149,3195
MCI,ABQ,1070,204,2,3,1279
MCI,ATL,9572,1433,30,153,11188
MCI,BNA,3093,487,5,13,3598
MCI,BOS,147,18,0,0,165
MCI,BWI,2398,482,10,42,2932
MCI,CLE,2829,600,2,36,3467
MCI,CLT,3122,446,8,37,3613
MCI,COS,1,0,0,0,1
MCI,CVG,847,67,2,13,929
MCI,DAL,7601,1566,28,72,9267
MCI,DCA,0,1,0,0,1
MCI,DEN,10999,2085,42,125,13251
MCI,DFW,7127,1123,13,188,8451
MCI,DSM,0,1,0,0,1
MCI,DTW,2944,432,4,65,3445
MCI,EWR,3235,1489,16,230,4970
MCI,FLL,806,100,4,4,914
MCI,HOU,274,25,3,2,304
MCI,IAD,1595,293,8,24,1920
MCI,IAH,7480,1635,30,89,9234
MCI,IND,1627,372,0,9,2008
MCI,JFK,64,87,0,10,161
MCI,LAS,3762,581,7,19,4369
MCI,LAX,2291,485,3,12,2791
MCI,LGA,462,245,6,57,770
MCI,MCO,2707,503,8,11,3229
MCI,MDW,8041,1825,28,101,9995
MCI,MEM,1832,233,6,42,2113
MCI,MKE,2075,381,6,24,2486
MCI,MSP,3249,561,5,69,3884
MCI,MSY,54,4,0,1,59
MCI,OAK,881,140,1,6,1028
MCI,OKC,1771,360,4,7,2142
MCI,OMA,0,0,0,1,1
MCI,ORD,10336,2391,20,389,13136
MCI,PDX,877,198,4,2,1081
MCI,PHX,5724,681,5,38,6448
MCI,PIA,0,1,0,0,1
MCI,RSW,6,0,0,0,6
MCI,SAN,1567,282,7,5,1861
MCI,SEA,969,141,1,0,1111
MCI,SFO,1427,369,6,21,1823
MCI,SLC,2074,237,5,17,2333
MCI,STL,4065,709,4,26,4804
MCI,TPA,1579,280,3,6,1868
MCO,ABE,1078,136,3,6,1223
MCO,ABQ,834,147,0,0,981
MCO,ACY,94,16,0,3,113
MCO,ALB,2129,414,3,13,2559
MCO,ATL,22951,4327,38,171,27487
MCO,AUS,2275,434,4,3,2716
MCO,AVL,340,27,1,2,370
MCO,BDL,4742,1091,12,66,5911
MCO,BHM,1874,310,2,3,2189
MCO,BKG,139,16,0,2,157
MCO,BMI,485,53,1,1,540
MCO,BNA,4291,654,7,32,4984
MCO,BOS,7940,2269,11,118,10338
MCO,BQN,1172,297,2,7,1478
MCO,BTV,699,291,5,5,1000
MCO,BUF,4621,1124,15,21,5781
MCO,BWI,10996,2086,51,186,13319
MCO,CAK,1651,222,5,3,1881
MCO,CLE,2381,400,2,11,2794
MCO,CLT,8428,1506,16,67,10017
MCO,CMH,3504,546,8,6,4064
MCO,COS,9,10,0,0,19
MCO,COU,11,1,0,0,12
MCO,CRW,327,59,5,2,393
MCO,CVG,2801,310,4,24,3139
MCO,DAY,999,198,6,5,1208
MCO,DCA,6955,1318,30,160,8463
MCO,DEN,7485,1231,32,30,8778
MCO,DFW,9152,1889,42,130,11213
MCO,DSM,127,13,1,0,141
MCO,DTW,7512,1075,18,19,8624
MCO,ECP,1510,328,8,1,1847
MCO,EWR,10423,3885,48,253,14609
MCO,EYW,898,76,2,4,980
MCO,FLL,3771,876,2,24,4673
MCO,FNT,831,193,2,1,1027
MCO,GRR,826,101,2,3,932
MCO,GSO,18,1,0,0,19
MCO,GSP,586,74,0,0,660
MCO,HOU,3901,694,17,17,4629
MCO,HPN,4062,1027,44,88,5221
MCO,HSV,695,111,1,2,809
MCO,IAD,6193,1419,13,102,7727
MCO,IAH,5323,1102,16,24,6465
MCO,ICT,12,2,0,0,14
MCO,IND,4234,638,10,18,4900
MCO,ISP,3850,818,15,80,4763
MCO,JAN,894,145,4,4,1047
MCO,JFK,12201,3806,58,306,16371
MCO,LAS,2037,301,7,3,2348
MCO,LAX,4836,1039,17,16,5908
MCO,LEX,577,73,1,0,651
MCO,LGA,7058,2215,51,217,9541
MCO,MCI,2697,510,10,9,3226
MCO,MDT,1197,89,4,3,1293
MCO,MDW,7924,1502,46,80,9552
MCO,MEM,2740,378,5,18,3141
MCO,MHT,2545,468,5,21,3039
MCO,MIA,7361,2283,14,106,9764
MCO,MKE,4747,722,18,29,5516
MCO,MLI,362,32,3,2,399
MCO,MSN,38,6,0,0,44
MCO,MSP,4706,647,13,19,5385
MCO,MSY,3796,692,8,21,4517
MCO,OMA,21,1,0,0,22
MCO,ORD,7985,1698,30,91,9804
MCO,ORF,1828,350,8,9,2195
MCO,PHF,653,126,2,4,785
MCO,PHL,13389,2889,27,251,16556
MCO,PHX,3039,455,6,6,3506
MCO,PIT,4722,816,9,27,5574
MCO,PSE,921,370,2,16,1309
MCO,PVD,4242,811,12,46,5111
MCO,PWM,422,105,2,4,533
MCO,RDU,3701,609,7,36,4353
MCO,RIC,1693,418,6,13,2130
MCO,ROC,1267,183,2,1,1453
MCO,RSW,3152,781,1,7,3941
MCO,SAN,57,1,0,1,59
MCO,SAT,1615,239,8,1,1863
MCO,SDF,1007,120,1,0,1128
MCO,SEA,1481,181,3,2,1667
MCO,SFO,1536,287,5,10,1838
MCO,SHD,15,3,0,0,18
MCO,SJU,7186,1950,11,22,9169
MCO,SLC,1893,210,3,5,2111
MCO,STL,4095,749,16,13,4873
MCO,SWF,1065,283,3,17,1368
MCO,SYR,1296,460,0,6,1762
MCO,TTN,11,3,0,0,14
MCO,TYS,642,60,0,3,705
MDT,ATL,3774,888,20,103,4785
MDT,CLE,1,2,0,0,3
MDT,CLT,2901,324,8,69,3302
MDT,CVG,623,90,1,15,729
MDT,DEN,58,10,0,0,68
MDT,DTW,1350,250,5,32,1637
MDT,EWR,13,4,0,2,19
MDT,FLL,107,19,2,1,129
MDT,MCO,1160,129,2,3,1294
MDT,ORD,4323,819,10,176,5328
MDW,ABQ,1729,412,9,14,2164
MDW,ALB,1556,562,2,24,2144
MDW,ATL,12392,2325,30,263,15010
MDW,AUS,1699,476,5,12,2192
MDW,BDL,2114,762,1,38,2915
MDW,BHM,1621,496,6,16,2139
MDW,BKG,322,33,1,5,361
MDW,BNA,5902,1531,12,59,7504
MDW,BOS,4056,1046,9,79,5190
MDW,BUF,2811,978,3,32,3824
MDW,BWI,5250,1571,28,154,7003
MDW,CAK,247,33,1,3,284
MDW,CHS,1047,255,4,5,1311
MDW,CLE,5317,1319,5,64,6705
MDW,CMH,5241,1432,10,65,6748
MDW,DEN,10895,2196,37,155,13283
MDW,DSM,121,63,0,2,186
MDW,DTW,6181,1845,11,157,8194
MDW,EWR,2450,1082,24,101,3657
MDW,FLL,3385,876,13,32,4306
MDW,GSP,1043,214,2,3,1262
MDW,HOU,5180,1124,22,63,6389
MDW,IAD,4766,1259,15,94,6134
MDW,IND,2505,903,1,36,3445
MDW,ISP,2154,502,10,55,2721
MDW,JAN,1208,343,4,13,1568
MDW,LAS,7859,1620,15,85,9579
MDW,LAX,4891,1300,15,59,6265
MDW,LGA,3681,1512,27,123,5343
MDW,LIT,792,293,7,9,1101
MDW,MCI,7767,2141,32,94,10034
MDW,MCO,7953,1526,19,73,9571
MDW,MHT,2698,837,4,41,3580
MDW,MSP,6555,1710,15,115,8395
MDW,MSY,1314,281,3,14,1612
MDW,OAK,2475,747,4,18,3244
MDW,OKC,180,32,0,0,212
MDW,OMA,4501,1178,13,50,5742
MDW,ONT,819,200,1,3,1023
MDW,ORF,1539,574,8,26,2147
MDW,PDX,1467,421,5,10,1903
MDW,PHL,4829,1455,19,149,6452
MDW,PHX,5815,1319,8,77,7219
MDW,PIT,4310,1247,4,52,5613
MDW,PVD,2609,701,8,49,3367
MDW,RDU,2701,762,8,25,3496
MDW,RNO,859,226,3,4,1092
MDW,RSW,3625,830,17,21,4493
MDW,SAN,3101,845,14,24,3984
MDW,SAT,1643,425,4,15,2087
MDW,SDF,3750,955,7,39,4751
MDW,SEA,2205,722,8,15,2950
MDW,SFO,1954,920,4,15,2893
MDW,SJC,870,221,4,6,1101
MDW,SLC,1612,526,3,11,2152
MDW,SMF,1006,216,2,5,1229
MDW,SNA,690,172,1,6,869
MDW,SRQ,1362,181,11,10,1564
MDW,STL,7504,2084,13,101,9702
MDW,TPA,4090,897,20,31,5038
MDW,TUS,1416,402,2,11,1831
MEI,ATL,1482,361,1,51,1895
MEM,AEX,505,61,1,22,589
MEM,AMA,437,119,1,4,561
MEM,ATL,10912,2633,21,196,13762
MEM,ATW,3,0,0,0,3
MEM,AUS,872,147,2,17,1038
MEM,BHM,1878,243,2,29,2152
MEM,BNA,2038,293,2,45,2378
MEM,BOS,404,180,0,11,595
MEM,BTR,1773,274,3,47,2097
MEM,BWI,707,187,1,27,922
MEM,CHA,592,102,4,18,716
MEM,CHS,33,6,0,2,41
MEM,CLE,1103,165,6,26,1300
MEM,CLT,5964,981,27,82,7054
MEM,CMH,593,130,1,12,736
MEM,COS,0,0,1,0,1
MEM,COU,886,129,4,15,1034
MEM,CVG,719,142,2,14,877
MEM,DAL,893,137,2,28,1060
MEM,DCA,2244,524,6,71,2845
MEM,DEN,1934,370,9,39,2352
MEM,DFW,4527,774,14,196,5511
MEM,DSM,1550,235,8,24,1817
MEM,DTW,2945,441,3,41,3430
MEM,ECP,1142,130,3,34,1309
MEM,EVV,350,40,1,5,396
MEM,EWR,1986,1285,20,254,3545
MEM,FLL,1065,154,4,5,1228
MEM,FSM,1052,139,3,25,1219
MEM,GPT,1325,179,3,24,1531
MEM,GRR,753,174,3,12,942
MEM,GSO,243,42,2,8,295
MEM,GTR,368,57,2,22,449
MEM,HSV,1550,207,4,48,1809
MEM,IAH,6040,1398,21,118,7577
MEM,ICT,1118,188,3,16,1325
MEM,IND,983,155,0,13,1151
MEM,JAN,2375,302,3,61,2741
MEM,JAX,1798,252,5,33,2088
MEM,JFK,110,26,1,8,145
MEM,LAS,2135,364,3,13,2515
MEM,LAX,2370,477,5,18,2870
MEM,LBB,790,109,3,18,920
MEM,LEX,750,92,2,12,856
MEM,LFT,1117,161,4,34,1316
MEM,LGA,2450,553,10,84,3097
MEM,LIT,2288,320,2,55,2665
MEM,LNK,13,8,0,1,22
MEM,MCI,1694,337,4,34,2069
MEM,MCO,2645,482,4,12,3143
MEM,MFE,801,206,2,19,1028
MEM,MGM,1158,129,0,45,1332
MEM,MIA,1802,385,9,26,2222
MEM,MKE,2119,344,13,52,2528
MEM,MLI,568,102,4,4,678
MEM,MLU,789,86,1,38,914
MEM,MOB,1635,196,3,43,1877
MEM,MSN,535,124,4,8,671
MEM,MSP,3202,444,12,55,3713
MEM,MSY,1803,288,1,28,2120
MEM,OKC,1825,307,3,38,2173
MEM,OMA,2064,328,7,30,2429
MEM,ORD,6849,1948,25,312,9134
MEM,PBI,77,15,0,3,95
MEM,PFN,347,62,0,11,420
MEM,PHL,809,250,4,57,1120
MEM,PHX,1762,290,6,15,2073
MEM,PIT,1083,200,4,13,1300
MEM,PNS,1832,261,5,33,2131
MEM,RDU,1592,308,3,30,1933
MEM,RSW,50,15,0,0,65
MEM,SAN,75,17,1,0,93
MEM,SAT,1977,341,2,34,2354
MEM,SDF,641,71,3,14,729
MEM,SEA,620,124,1,10,755
MEM,SFO,177,83,1,3,264
MEM,SGF,1743,222,3,43,2011
MEM,SHV,2412,304,6,71,2793
MEM,SJU,25,3,0,0,28
MEM,SLC,1500,303,2,8,1813
MEM,STL,1373,189,4,44,1610
MEM,SYR,1,0,0,0,1
MEM,TLH,702,102,0,11,815
MEM,TPA,1550,235,3,15,1803
MEM,TUL,1667,257,5,38,1967
MEM,TUP,1,0,0,0,1
MEM,TYS,1001,143,2,11,1157
MEM,VPS,1207,202,5,30,1444
MEM,XNA,1818,260,5,60,2143
MFE,ATL,551,89,1,10,651
MFE,DFW,3548,480,13,151,4192
MFE,IAH,4360,728,6,51,5145
MFE,MEM,856,140,1,31,1028
MFR,ACV,0,1,0,0,1
MFR,CEC,0,1,1,1,3
MFR,DEN,1394,216,6,24,1640
MFR,PDX,1057,75,2,14,1148
MFR,SBP,0,0,1,0,1
MFR,SFO,4149,2281,16,288,6734
MFR,SLC,1981,101,0,16,2098
MGM,ATL,6699,1697,6,166,8568
MGM,DFW,2473,492,13,70,3048
MGM,MEM,1134,161,2,37,1334
MHK,DFW,2595,486,11,59,3151
MHK,ORD,932,178,1,29,1140
MHT,ATL,1222,199,3,16,1440
MHT,BWI,7064,1241,28,125,8458
MHT,CLE,2132,324,2,42,2500
MHT,CLT,402,34,0,7,443
MHT,DEN,424,30,1,2,457
MHT,DTW,996,246,4,18,1264
MHT,EWR,2233,822,6,170,3231
MHT,FLL,150,16,0,0,166
MHT,IAD,1289,275,8,55,1627
MHT,LAS,776,75,1,7,859
MHT,LGA,6,1,0,0,7
MHT,MCO,2630,368,8,23,3029
MHT,MDW,3105,391,12,38,3546
MHT,ORD,1037,287,10,42,1376
MHT,PHL,2903,586,7,95,3591
MHT,PHX,503,99,2,3,607
MHT,PVD,0,1,0,1,2
MHT,TPA,1769,210,5,14,1998
MIA,ATL,14425,3595,50,248,18318
MIA,BDL,902,369,3,26,1300
MIA,BHM,1590,344,7,33,1974
MIA,BNA,2425,694,15,33,3167
MIA,BOS,4965,2228,20,135,7348
MIA,BWI,2698,702,11,52,3463
MIA,CHS,1283,400,11,14,1708
MIA,CLE,1640,561,13,27,2241
MIA,CLT,8927,2174,43,127,11271
MIA,CMH,1517,495,7,16,2035
MIA,CVG,2274,599,11,39,2923
MIA,DCA,7329,2418,47,243,10037
MIA,DEN,1485,590,6,21,2102
MIA,DFW,8020,2525,63,151,10759
MIA,DTW,3381,764,8,38,4191
MIA,EGE,222,59,9,2,292
MIA,EWR,5901,2150,35,204,8290
MIA,EYW,251,27,0,2,280
MIA,GNV,824,159,1,18,1002
MIA,GSO,1050,346,8,12,1416
MIA,IAD,2977,651,5,60,3693
MIA,IAH,6254,1394,21,88,7757
MIA,IND,1486,521,10,20,2037
MIA,JAX,1411,420,2,42,1875
MIA,JFK,8274,3035,47,295,11651
MIA,LAS,2578,722,16,19,3335
MIA,LAX,6011,2428,22,63,8524
MIA,LGA,8525,2958,97,310,11890
MIA,MCO,7337,2433,9,96,9875
MIA,MEM,1864,326,8,24,2222
MIA,MSP,2285,633,8,32,2958
MIA,MSY,2544,658,4,54,3260
MIA,ORD,7348,2971,45,211,10575
MIA,ORF,1581,551,14,45,2191
MIA,PHL,5232,1289,12,141,6674
MIA,PHX,856,273,6,8,1143
MIA,PIT,1384,463,9,15,1871
MIA,PNS,1863,490,9,42,2404
MIA,RDU,2501,729,7,35,3272
MIA,RIC,1019,342,12,21,1394
MIA,ROA,1,0,0,0,1
MIA,RSW,275,66,0,11,352
MIA,SAV,115,57,2,8,182
MIA,SDF,1121,269,12,13,1415
MIA,SEA,876,249,2,2,1129
MIA,SFO,2108,1106,24,50,3288
MIA,SJU,5875,2340,19,55,8289
MIA,SLC,1,0,0,0,1
MIA,STL,1597,667,4,60,2328
MIA,STT,1869,768,14,26,2677
MIA,STX,1257,341,3,18,1619
MIA,TLH,2110,559,21,63,2753
MIA,TPA,5535,1270,13,80,6898
MIA,TUL,62,23,0,0,85
MIA,TYS,785,158,7,10,960
MKE,ATL,9577,1758,27,138,11500
MKE,BOS,2869,722,6,52,3649
MKE,BWI,3920,650,19,75,4664
MKE,CAK,1555,274,5,43,1877
MKE,CLE,2965,771,3,54,3793
MKE,CVG,1648,170,3,42,1863
MKE,DCA,3837,662,14,84,4597
MKE,DEN,6661,1544,15,55,8275
MKE,DFW,3966,1029,21,88,5104
MKE,DSM,1593,296,5,24,1918
MKE,DTW,3668,703,0,60,4431
MKE,EWR,1818,1083,5,141,3047
MKE,FLL,849,134,3,1,987
MKE,IAH,3308,1015,31,41,4395
MKE,IND,1253,365,3,33,1654
MKE,JFK,2,2,0,0,4
MKE,LAS,4831,827,7,29,5694
MKE,LAX,1874,606,3,10,2493
MKE,LGA,4387,1485,26,157,6055
MKE,MCI,2135,324,7,20,2486
MKE,MCO,4566,914,10,32,5522
MKE,MEM,2005,334,7,39,2385
MKE,MQT,43,15,1,1,60
MKE,MSP,8044,1633,8,132,9817
MKE,MSY,384,68,1,3,456
MKE,OMA,1168,334,4,31,1537
MKE,ORD,7483,1943,1,332,9759
MKE,PHX,4878,730,11,35,5654
MKE,PIE,92,20,0,1,113
MKE,PIT,1373,303,0,38,1714
MKE,RSW,1751,283,9,11,2054
MKE,SAN,288,65,1,3,357
MKE,SEA,1120,255,1,6,1382
MKE,SFO,1185,509,3,5,1702
MKE,SRQ,300,54,1,2,357
MKE,STL,2127,430,1,64,2622
MKE,TPA,1983,347,5,15,2350
MKG,ORD,1650,387,1,135,2173
MLB,ATL,3882,869,10,62,4823
MLI,ATL,3962,920,16,94,4992
MLI,COS,0,0,1,0,1
MLI,DEN,1305,293,14,19,1631
MLI,DFW,1984,438,9,48,2479
MLI,DTW,841,146,2,15,1004
MLI,MCO,356,41,0,2,399
MLI,MEM,555,117,0,6,678
MLI,MSP,293,26,0,1,320
MLI,OMA,0,0,1,0,1
MLI,ORD,4501,1040,3,212,5756
MLI,RSW,42,2,0,0,44
MLU,ATL,2876,603,7,87,3573
MLU,DFW,1559,304,2,53,1918
MLU,IAH,1022,157,3,25,1207
MLU,MEM,765,113,1,37,916
MMH,SAN,87,29,0,20,136
MMH,SFO,196,82,0,68,346
MMH,SNA,53,15,0,11,79
MOB,ATL,6510,1593,12,164,8279
MOB,DFW,2759,482,26,70,3337
MOB,EFD,0,0,1,0,1
MOB,IAH,4115,862,15,95,5087
MOB,MEM,1624,207,2,46,1879
MOD,SFO,2947,1087,3,396,4433
MOT,DEN,1767,511,6,66,2350
MOT,MSP,2834,536,3,84,3457
MOT,SLC,210,39,0,2,251
MQT,DTW,37,2,0,2,41
MQT,GRB,344,49,9,13,415
MQT,MKE,74,16,1,4,95
MQT,MSP,35,10,0,3,48
MQT,ORD,802,140,1,16,959
MQT,TVC,350,52,6,10,418
MRY,DEN,991,112,3,17,1123
MRY,LAX,5704,941,7,104,6756
MRY,OTH,0,1,0,0,1
MRY,PHX,2323,241,2,57,2623
MRY,SFO,3946,1956,1,531,6434
MSN,ATL,1134,151,4,32,1321
MSN,CLE,1004,241,0,23,1268
MSN,CVG,356,28,1,4,389
MSN,DCA,308,87,3,20,418
MSN,DEN,2821,553,6,52,3432
MSN,DFW,2298,447,15,62,2822
MSN,DTW,3096,546,3,58,3703
MSN,EWR,583,329,1,29,942
MSN,IAH,1,0,0,0,1
MSN,LGA,112,37,2,8,159
MSN,MCO,35,9,0,0,44
MSN,MEM,573,84,2,13,672
MSN,MSP,2895,405,2,52,3354
MSN,ORD,6843,1496,8,357,8704
MSO,BZN,0,1,0,0,1
MSO,DEN,3432,543,14,57,4046
MSO,FCA,1,0,0,0,1
MSO,HLN,0,1,0,0,1
MSO,MSP,236,34,1,0,271
MSO,ORD,223,62,3,4,292
MSO,SFO,252,146,0,6,404
MSO,SLC,4070,414,7,29,4520
MSP,ABQ,1410,281,2,5,1698
MSP,ABR,567,41,1,8,617
MSP,ALB,161,45,0,6,212
MSP,ALO,94,13,0,3,110
MSP,ANC,1544,654,4,3,2205
MSP,APN,104,10,2,2,118
MSP,ATL,13750,2681,50,129,16610
MSP,ATW,1945,261,5,32,2243
MSP,AUS,490,89,1,2,582
MSP,AZO,331,60,3,10,404
MSP,BDL,1529,276,2,25,1832
MSP,BHM,207,19,0,5,231
MSP,BIL,862,149,0,5,1016
MSP,BIS,4226,658,12,72,4968
MSP,BJI,607,49,0,13,669
MSP,BMI,392,54,1,12,459
MSP,BNA,2503,544,7,47,3101
MSP,BOI,805,147,1,7,960
MSP,BOS,4183,1000,1,71,5255
MSP,BRD,139,10,0,3,152
MSP,BUF,78,31,0,1,110
MSP,BWI,2465,580,8,57,3110
MSP,BZN,1124,218,3,8,1353
MSP,CID,1719,222,5,33,1979
MSP,CLE,3821,759,8,64,4652
MSP,CLT,3790,643,7,55,4495
MSP,CMH,1375,291,2,19,1687
MSP,COS,877,219,2,9,1107
MSP,CVG,2637,549,9,41,3236
MSP,CWA,82,7,1,1,91
MSP,DAY,2001,306,10,28,2345
MSP,DCA,4696,1008,20,74,5798
MSP,DEN,14500,2990,19,117,17626
MSP,DFW,7030,1256,28,122,8436
MSP,DLH,2801,383,1,83,3268
MSP,DSM,1465,295,4,23,1787
MSP,DTW,7962,1370,10,44,9386
MSP,EGE,70,13,2,3,88
MSP,EWR,4240,1844,26,239,6349
MSP,FAI,384,167,1,2,554
MSP,FAR,3861,685,5,72,4623
MSP,FCA,510,136,1,5,652
MSP,FLL,1235,244,2,8,1489
MSP,FNT,759,114,2,7,882
MSP,FSD,3215,599,7,68,3889
MSP,FWA,147,35,0,1,183
MSP,GEG,1945,430,9,18,2402
MSP,GFK,3661,632,11,131,4435
MSP,GRB,2155,366,4,47,2572
MSP,GRR,3029,656,10,38,3733
MSP,GTF,14,4,0,0,18
MSP,HDN,8,3,2,0,13
MSP,HIB,136,15,1,6,158
MSP,HLN,63,12,0,2,77
MSP,HNL,212,68,1,1,282
MSP,IAD,152,47,1,0,200
MSP,IAH,5145,1264,24,70,6503
MSP,ICT,2079,317,4,19,2419
MSP,IMT,29,1,0,1,31
MSP,IND,2637,529,4,23,3193
MSP,INL,15,2,0,0,17
MSP,ISN,82,7,2,2,93
MSP,JAC,141,35,0,0,176
MSP,JAX,94,23,1,0,118
MSP,JFK,1396,445,6,67,1914
MSP,LAN,361,56,0,7,424
MSP,LAS,5357,1109,8,36,6510
MSP,LAX,5570,1453,12,34,7069
MSP,LEX,277,64,2,7,350
MSP,LGA,7934,2093,37,332,10396
MSP,LIT,50,16,1,0,67
MSP,LNK,1002,167,6,14,1189
MSP,LSE,2382,326,6,65,2779
MSP,MBS,356,59,2,4,421
MSP,MCI,3159,633,8,62,3862
MSP,MCO,4321,1035,8,20,5384
MSP,MDW,6883,1384,19,120,8406
MSP,MEM,3168,527,6,43,3744
MSP,MIA,2539,381,9,29,2958
MSP,MKE,8232,1422,25,123,9802
MSP,MLI,281,28,0,2,311
MSP,MOT,2875,495,20,66,3456
MSP,MQT,36,9,1,2,48
MSP,MSN,2894,522,7,41,3464
MSP,MSO,223,48,0,0,271
MSP,MSY,276,82,0,7,365
MSP,OKC,1185,275,4,25,1489
MSP,OMA,3158,725,5,54,3942
MSP,ORD,14461,3684,22,481,18648
MSP,ORF,21,5,0,0,26
MSP,PDX,3224,911,3,10,4148
MSP,PHL,4268,1087,3,123,5481
MSP,PHX,10270,1957,22,62,12311
MSP,PIA,414,94,1,14,523
MSP,PIT,1553,312,5,24,1894
MSP,PSC,292,87,0,6,385
MSP,PSP,94,9,1,0,104
MSP,PVD,103,31,0,3,137
MSP,RAP,3759,641,15,70,4485
MSP,RDU,681,205,3,8,897
MSP,RIC,64,9,0,0,73
MSP,RNO,299,31,1,2,333
MSP,ROC,45,15,0,2,62
MSP,RST,1997,289,3,80,2369
MSP,RSW,2110,404,3,12,2529
MSP,SAN,2882,616,13,17,3528
MSP,SAT,685,147,1,6,839
MSP,SBN,750,101,1,9,861
MSP,SDF,688,278,2,24,992
MSP,SEA,7010,1347,4,27,8388
MSP,SFO,4927,1982,11,41,6961
MSP,SGF,54,13,0,1,68
MSP,SJC,1474,350,3,9,1836
MSP,SJU,68,6,0,0,74
MSP,SLC,4311,928,5,29,5273
MSP,SMF,1677,480,4,11,2172
MSP,SNA,2548,449,2,12,3011
MSP,STL,5595,1012,14,65,6686
MSP,SUX,135,18,0,5,158
MSP,SYR,67,10,0,7,84
MSP,TPA,2332,429,14,11,2786
MSP,TUL,878,281,2,22,1183
MSP,TUS,896,149,3,2,1050
MSP,TVC,638,103,1,14,756
MSP,TYS,289,57,1,2,349
MSP,XNA,1292,212,6,21,1531
MSY,ATL,13109,2402,10,228,15749
MSY,BHM,1653,334,3,9,1999
MSY,BNA,2458,484,2,9,2953
MSY,BOS,785,211,4,15,1015
MSY,BWI,2526,548,11,30,3115
MSY,CLE,349,49,0,5,403
MSY,CLT,4145,534,3,66,4748
MSY,CMH,1,0,0,0,1
MSY,CVG,358,92,1,8,459
MSY,DAL,5560,1138,14,47,6759
MSY,DCA,192,15,0,5,212
MSY,DEN,4439,710,15,37,5201
MSY,DFW,5412,856,16,118,6402
MSY,DTW,1462,246,6,30,1744
MSY,EWR,1737,517,11,54,2319
MSY,FLL,1507,385,7,4,1903
MSY,HOU,8257,1694,11,104,10066
MSY,IAD,1356,240,4,28,1628
MSY,IAH,9245,1540,14,102,10901
MSY,JFK,2382,516,8,72,2978
MSY,LAS,1835,267,5,6,2113
MSY,LAX,3082,579,5,24,3690
MSY,LFT,0,1,0,0,1
MSY,LGA,2340,561,18,94,3013
MSY,MCI,49,10,0,0,59
MSY,MCO,3802,715,12,24,4553
MSY,MDW,1334,250,3,15,1602
MSY,MEM,1891,200,1,28,2120
MSY,MIA,2775,419,7,58,3259
MSY,MKE,388,57,4,6,455
MSY,MSP,277,73,2,12,364
MSY,ORD,3205,739,9,70,4023
MSY,PHL,1459,296,3,23,1781
MSY,PHX,913,176,2,6,1097
MSY,SFO,536,135,4,7,682
MSY,SLC,936,143,3,12,1094
MSY,STL,810,151,1,6,968
MSY,TPA,2684,497,5,13,3199
MSY,VPS,0,1,0,0,1
MTJ,ATL,123,53,3,2,181
MTJ,DEN,3459,619,7,119,4204
MTJ,DFW,533,144,2,8,687
MTJ,EWR,40,20,1,2,63
MTJ,GUC,0,0,1,0,1
MTJ,IAH,425,80,3,4,512
MTJ,LAX,69,22,0,3,94
MTJ,LBB,1,0,0,0,1
MTJ,ORD,276,108,0,9,393
MTJ,SLC,158,17,0,1,176
MVY,JFK,156,62,0,3,221
MWH,SEA,263,3,2,4,272
MYR,ATL,4794,1024,12,108,5938
MYR,CAE,0,1,0,0,1
MYR,CLT,3648,546,2,69,4265
MYR,DFW,153,51,1,4,209
MYR,DTW,198,47,1,2,248
MYR,EWR,179,43,1,22,245
MYR,LGA,61,30,0,7,98
OAJ,ATL,3681,839,11,80,4611
OAJ,CLT,265,42,0,3,310
OAK,ABQ,2298,443,10,6,2757
OAK,ATL,69,32,1,1,103
OAK,AUS,918,137,5,1,1061
OAK,BNA,133,34,1,0,168
OAK,BOI,1646,410,1,2,2059
OAK,BOS,260,107,0,4,371
OAK,BUR,11400,1981,13,319,13713
OAK,DEN,4742,749,11,29,5531
OAK,GEG,1662,404,5,4,2075
OAK,HNL,1131,182,5,2,1320
OAK,HOU,1651,364,8,10,2033
OAK,IAD,628,190,1,13,832
OAK,JFK,975,348,5,28,1356
OAK,KOA,584,53,1,0,638
OAK,LAS,7443,1573,9,51,9076
OAK,LAX,13100,2963,10,513,16586
OAK,LGB,3358,503,3,17,3881
OAK,LIH,443,50,3,0,496
OAK,MCI,912,109,1,6,1028
OAK,MDW,2701,513,15,22,3251
OAK,OGG,1208,107,4,1,1320
OAK,ONT,7017,1250,7,60,8334
OAK,PDX,4852,1069,4,14,5939
OAK,PHX,9761,1412,13,103,11289
OAK,RNO,2446,454,5,12,2917
OAK,SAN,10192,1979,28,229,12428
OAK,SEA,9535,1501,8,43,11087
OAK,SLC,7822,1116,7,41,8986
OAK,SNA,6580,993,9,49,7631
OGG,ANC,138,56,1,0,195
OGG,BLI,26,4,1,0,31
OGG,DEN,409,31,1,5,446
OGG,DFW,933,183,7,5,1128
OGG,HNL,32913,2805,2,238,35958
OGG,ITO,1341,50,0,2,1393
OGG,KOA,2569,147,1,2,2719
OGG,LAS,180,18,1,0,199
OGG,LAX,6772,1138,24,42,7976
OGG,LIH,895,127,2,14,1038
OGG,OAK,1133,181,5,1,1320
OGG,ORD,97,10,3,0,110
OGG,PDX,1666,309,4,2,1981
OGG,PHX,1546,121,6,24,1697
OGG,SAN,826,140,13,1,980
OGG,SEA,2394,421,7,5,2827
OGG,SFO,2279,257,5,31,2572
OGG,SJC,887,92,3,5,987
OGG,SLC,56,2,0,0,58
OGG,SMF,625,111,1,1,738
OGG,SNA,272,24,3,2,301
OKC,ATL,3635,933,9,84,4661
OKC,BWI,965,114,3,14,1096
OKC,CID,0,0,0,1,1
OKC,DAL,4162,735,8,48,4953
OKC,DEN,6348,1147,15,77,7587
OKC,DFW,6605,835,5,134,7579
OKC,DTW,1128,203,4,33,1368
OKC,EWR,870,132,5,36,1043
OKC,HOU,3241,555,3,30,3829
OKC,IAD,403,58,1,18,480
OKC,IAH,5053,1046,9,111,6219
OKC,LAS,1692,248,6,6,1952
OKC,LAX,2066,416,4,21,2507
OKC,MCI,1872,245,5,10,2132
OKC,MDW,195,17,0,0,212
OKC,MEM,1557,243,3,45,1848
OKC,MSP,1522,247,5,42,1816
OKC,ORD,6404,1491,13,220,8128
OKC,PHX,1867,291,5,11,2174
OKC,SFO,426,57,2,3,488
OKC,SLC,2263,320,4,22,2609
OKC,STL,1656,293,3,9,1961
OKC,TUL,0,1,0,0,1
OMA,ATL,3267,628,4,73,3972
OMA,CLT,206,13,0,3,222
OMA,CVG,477,70,0,8,555
OMA,DCA,7,0,0,0,7
OMA,DEN,6961,1085,6,70,8122
OMA,DFW,4574,581,20,90,5265
OMA,DSM,0,1,0,0,1
OMA,DTW,1804,440,3,49,2296
OMA,EWR,1806,806,17,127,2756
OMA,FSD,0,0,2,0,2
OMA,IAH,4765,1079,25,54,5923
OMA,LAS,2529,269,2,6,2806
OMA,LGA,115,22,0,8,145
OMA,LNK,0,1,1,0,2
OMA,MCI,0,1,0,0,1
OMA,MCO,20,2,0,0,22
OMA,MDW,4822,828,17,46,5713
OMA,MEM,2105,280,2,41,2428
OMA,MKE,1249,255,1,32,1537
OMA,MSP,3036,637,1,61,3735
OMA,ORD,7710,1806,12,240,9768
OMA,PHX,4565,440,7,33,5045
OMA,SFO,1,0,0,0,1
OMA,SLC,1977,213,4,24,2218
OMA,STL,2602,389,4,14,3009
OME,ANC,1702,390,7,80,2179
OME,OTZ,853,155,22,37,1067
ONT,ATL,1042,141,9,6,1198
ONT,BNA,59,4,0,0,63
ONT,BUR,0,2,0,0,2
ONT,DEN,4362,554,10,28,4954
ONT,DFW,3900,563,27,46,4536
ONT,IAH,2520,231,5,7,2763
ONT,LAS,6588,1017,2,25,7632
ONT,LAX,0,1,0,0,1
ONT,MDW,897,119,3,5,1024
ONT,OAK,7031,1260,0,70,8361
ONT,PDX,1561,167,1,25,1754
ONT,PHX,11717,1371,7,79,13174
ONT,SEA,2851,249,4,16,3120
ONT,SFO,2911,1279,8,171,4369
ONT,SJC,4559,691,5,46,5301
ONT,SLC,4052,249,5,32,4338
ONT,SMF,6813,1058,2,95,7968
ORD,ABE,3434,1148,10,202,4794
ORD,ABQ,1701,617,5,42,2365
ORD,ALB,2979,905,8,103,3995
ORD,ALO,409,88,0,12,509
ORD,ANC,1237,415,6,4,1662
ORD,ART,584,91,9,19,703
ORD,ASE,836,389,70,44,1339
ORD,ATL,16569,5234,67,551,22421
ORD,ATW,4122,1240,8,292,5662
ORD,AUS,4453,1519,13,87,6072
ORD,AVL,1716,485,9,40,2250
ORD,AVP,2182,895,13,102,3192
ORD,AZO,1930,436,6,131,2503
ORD,BDL,6871,2007,18,249,9145
ORD,BHM,2060,827,11,72,2970
ORD,BIL,215,104,0,2,321
ORD,BIS,654,167,3,22,846
ORD,BMI,798,202,3,65,1068
ORD,BNA,9026,2803,25,313,12167
ORD,BOI,1008,448,14,10,1480
ORD,BOS,14294,4719,20,485,19518
ORD,BTV,1721,580,11,93,2405
ORD,BUF,7491,2152,19,219,9881
ORD,BWI,7499,2012,21,278,9810
ORD,BZN,548,224,4,6,782
ORD,CAE,1870,1008,10,167,3055
ORD,CAK,2167,673,10,110,2960
ORD,CHA,1535,346,3,50,1934
ORD,CHO,911,197,8,22,1138
ORD,CHS,2417,865,15,82,3379
ORD,CID,4886,1222,23,248,6379
ORD,CLE,11892,3787,12,377,16068
ORD,CLT,14588,3829,48,424,18889
ORD,CMH,10354,3173,15,319,13861
ORD,CMI,4160,1270,4,187,5621
ORD,CMX,1595,362,16,106,2079
ORD,COS,3329,1165,17,52,4563
ORD,CRW,2110,760,25,107,3002
ORD,CVG,8197,2372,17,438,11024
ORD,CWA,3525,993,19,233,4770
ORD,DAY,5517,1648,14,286,7465
ORD,DBQ,1242,263,6,85,1596
ORD,DCA,16507,4670,88,940,22205
ORD,DEN,11582,3246,35,240,15103
ORD,DFW,17774,4450,90,461,22775
ORD,DLH,1909,407,7,72,2395
ORD,DSM,9251,2397,21,352,12021
ORD,DTW,12565,3891,28,505,16989
ORD,EAU,1628,382,4,54,2068
ORD,EGE,280,84,10,6,380
ORD,ELP,2793,996,11,58,3858
ORD,EVV,3094,779,5,144,4022
ORD,EWR,13857,6023,51,1060,20991
ORD,FAR,5050,1426,20,215,6711
ORD,FCA,232,73,1,4,310
ORD,FLL,2758,968,11,33,3770
ORD,FNT,251,67,0,4,322
ORD,FSD,5490,1692,12,226,7420
ORD,FWA,4530,1137,4,266,5937
ORD,GEG,73,26,0,1,100
ORD,GJT,0,2,0,1,3
ORD,GRB,6428,1846,17,349,8640
ORD,GRR,4854,1368,3,228,6453
ORD,GSO,1816,750,6,71,2643
ORD,GSP,1706,650,8,76,2440
ORD,HDN,332,84,7,6,429
ORD,HNL,1200,472,10,10,1692
ORD,HPN,3793,1098,34,213,5138
ORD,HSV,2844,850,5,141,3840
ORD,IAD,5747,1429,12,190,7378
ORD,IAH,12452,4267,31,205,16955
ORD,ICT,6513,1993,22,269,8797
ORD,ILM,469,65,1,11,546
ORD,IND,5527,1671,9,230,7437
ORD,JAC,870,283,16,16,1185
ORD,JAN,42,14,1,1,58
ORD,JAX,3864,1003,11,88,4966
ORD,JFK,3795,1407,17,223,5442
ORD,LAN,2604,859,3,188,3654
ORD,LAS,8701,2227,23,85,11036
ORD,LAX,17517,4962,16,336,22831
ORD,LEX,4650,1278,12,204,6144
ORD,LGA,20930,6878,117,1428,29353
ORD,LGB,669,219,0,8,896
ORD,LIT,6339,1956,26,265,8586
ORD,LNK,2991,921,14,119,4045
ORD,LSE,1220,302,3,52,1577
ORD,MBS,2445,608,3,139,3195
ORD,MCI,9915,2808,34,362,13119
ORD,MCO,7564,2144,29,56,9793
ORD,MDT,3988,1172,11,166,5337
ORD,MEM,6739,2163,15,291,9208
ORD,MHK,885,233,3,20,1141
ORD,MHT,1012,340,1,34,1387
ORD,MIA,7591,2728,34,207,10560
ORD,MKE,7330,2109,8,290,9737
ORD,MKG,1682,361,3,127,2173
ORD,MLI,4166,1086,4,202,5458
ORD,MQT,688,285,3,18,994
ORD,MSN,6405,1852,7,339,8603
ORD,MSO,229,56,3,3,291
ORD,MSP,14566,4228,18,488,19300
ORD,MSY,3535,1081,11,68,4695
ORD,MTJ,280,103,4,6,393
ORD,OGG,183,48,0,0,231
ORD,OKC,6076,1924,15,200,8215
ORD,OMA,7518,2065,17,206,9806
ORD,ORF,2497,719,8,82,3306
ORD,PAH,1696,355,8,51,2110
ORD,PBI,1535,388,5,19,1947
ORD,PDX,4769,1226,12,41,6048
ORD,PHL,14590,4680,35,666,19971
ORD,PHX,11397,2550,27,151,14125
ORD,PIA,3382,917,7,212,4518
ORD,PIT,7909,2045,10,213,10177
ORD,PNS,475,154,7,18,654
ORD,PSP,840,212,14,9,1075
ORD,PVD,1754,424,1,54,2233
ORD,PWM,1719,533,8,80,2340
ORD,RAP,1572,449,9,44,2074
ORD,RDU,6344,1942,13,157,8456
ORD,RIC,5770,1695,16,208,7689
ORD,RNO,843,227,3,20,1093
ORD,ROA,1477,493,24,90,2084
ORD,ROC,6347,1922,22,214,8505
ORD,RST,2087,515,6,137,2745
ORD,RSW,1882,444,6,24,2356
ORD,SAN,7238,2056,39,83,9416
ORD,SAT,3478,1338,9,65,4890
ORD,SAV,2060,867,9,102,3038
ORD,SBN,3988,1293,3,322,5606
ORD,SDF,2923,814,6,70,3813
ORD,SEA,10964,2861,17,107,13949
ORD,SFO,14333,5645,36,314,20328
ORD,SGF,4668,1355,16,197,6236
ORD,SJC,1484,572,3,29,2088
ORD,SJU,1786,396,8,9,2199
ORD,SLC,6822,2294,36,124,9276
ORD,SMF,1644,459,3,13,2119
ORD,SNA,5062,1325,60,112,6559
ORD,SPI,3549,887,4,220,4660
ORD,SRQ,48,10,0,0,58
ORD,STL,7597,2055,7,298,9957
ORD,STT,109,32,0,0,141
ORD,SUX,398,103,1,8,510
ORD,SYR,5620,1684,20,209,7533
ORD,TOL,1059,278,0,48,1385
ORD,TPA,4939,1356,20,50,6365
ORD,TRI,854,185,0,37,1076
ORD,TUL,6230,1747,17,257,8251
ORD,TUS,1588,571,4,21,2184
ORD,TVC,4410,1248,17,197,5872
ORD,TYS,6014,1949,9,266,8238
ORD,XNA,6988,2340,23,342,9693
ORF,ATL,6510,997,12,124,7643
ORF,BNA,1015,66,1,9,1091
ORF,BWI,3624,836,6,56,4522
ORF,CLE,709,68,1,16,794
ORF,CLT,3747,400,5,88,4240
ORF,CVG,345,48,1,12,406
ORF,DFW,2014,398,16,44,2472
ORF,DTW,1340,337,4,71,1752
ORF,EWR,1268,605,2,144,2019
ORF,IAD,2634,555,2,105,3296
ORF,IAH,1448,414,15,23,1900
ORF,JAX,1688,257,1,11,1957
ORF,JFK,1005,369,2,109,1485
ORF,LAS,437,75,0,2,514
ORF,LGA,263,157,0,23,443
ORF,MCO,1874,282,2,15,2173
ORF,MDW,1785,310,8,23,2126
ORF,MIA,1733,399,2,57,2191
ORF,MSP,22,4,0,0,26
ORF,ORD,2304,465,11,62,2842
ORF,RIC,0,1,0,0,1
ORF,TPA,969,116,3,8,1096
OTH,PDX,659,207,2,25,893
OTH,SFO,1231,1112,12,96,2451
OTZ,ANC,850,174,0,43,1067
OTZ,OME,1681,321,46,77,2125
OXR,LAX,415,27,0,10,452
PAH,LIT,0,1,0,0,1
PAH,ORD,1647,394,7,61,2109
PBI,ATL,10630,1852,23,123,12628
PBI,BDL,612,184,0,10,806
PBI,BOS,3222,808,2,63,4095
PBI,BWI,2892,548,12,37,3489
PBI,CLE,760,110,0,10,880
PBI,CLT,4823,567,11,46,5447
PBI,CRP,0,0,1,0,1
PBI,CVG,73,16,0,0,89
PBI,DCA,1306,234,7,28,1575
PBI,DFW,1940,341,11,28,2320
PBI,DTW,1326,255,5,11,1597
PBI,EWR,5533,1722,26,149,7430
PBI,FLL,0,1,0,0,1
PBI,HPN,3742,696,32,84,4554
PBI,IAH,2738,586,14,24,3362
PBI,ISP,2232,452,17,42,2743
PBI,JFK,4774,1173,19,114,6080
PBI,LGA,4400,1484,38,176,6098
PBI,MEM,84,8,0,3,95
PBI,ORD,1598,321,8,20,1947
PBI,PHL,3990,761,8,92,4851
PBI,SJU,215,13,0,3,231
PBI,TPA,3372,469,4,13,3858
PDX,ABQ,907,113,2,1,1023
PDX,ANC,2050,244,3,3,2300
PDX,ATL,2837,387,13,17,3254
PDX,AUS,69,1,0,0,70
PDX,BOI,1761,228,0,6,1995
PDX,BOS,1151,166,2,6,1325
PDX,BUR,1536,224,6,19,1785
PDX,CLT,362,81,1,1,445
PDX,COS,41,10,1,1,53
PDX,DCA,119,5,0,2,126
PDX,DEN,11524,1551,15,42,13132
PDX,DFW,4064,576,27,53,4720
PDX,DTW,464,92,3,3,562
PDX,EUG,3636,418,7,55,4116
PDX,EWR,1449,331,7,30,1817
PDX,GEG,2110,319,7,8,2444
PDX,HNL,1716,413,8,1,2138
PDX,IAD,988,122,1,12,1123
PDX,IAH,3069,549,18,11,3647
PDX,JFK,1898,277,14,32,2221
PDX,KOA,164,43,0,0,207
PDX,LAS,6849,784,6,5,7644
PDX,LAX,8039,1155,5,26,9225
PDX,LGB,2631,301,2,15,2949
PDX,LIH,29,4,0,0,33
PDX,LMT,1200,155,7,6,1368
PDX,MCI,992,86,2,2,1082
PDX,MDW,1718,143,10,6,1877
PDX,MFR,1025,105,4,13,1147
PDX,MSP,3811,319,6,19,4155
PDX,OAK,5061,877,2,27,5967
PDX,OGG,1702,272,7,0,1981
PDX,ONT,1491,237,4,22,1754
PDX,ORD,5263,680,20,43,6006
PDX,OTH,784,93,9,5,891
PDX,PHL,398,81,1,8,488
PDX,PHX,10099,1033,15,46,11193
PDX,PSP,506,62,1,0,569
PDX,RDM,3139,300,0,32,3471
PDX,RNO,2289,333,4,5,2631
PDX,SAN,2980,321,13,3,3317
PDX,SBA,80,3,0,0,83
PDX,SEA,8623,771,12,97,9503
PDX,SFO,6546,2381,16,88,9031
PDX,SJC,5153,665,10,18,5846
PDX,SLC,7312,854,13,29,8208
PDX,SMF,5256,843,6,15,6120
PDX,SNA,3731,223,7,7,3968
PFN,ATL,880,226,1,38,1145
PFN,MEM,345,60,2,14,421
PHF,ATL,7472,1381,20,186,9059
PHF,BOS,990,162,1,16,1169
PHF,DEN,384,118,1,7,510
PHF,LGA,1065,407,7,43,1522
PHF,MCO,652,127,0,6,785
PHL,ANC,125,55,0,0,180
PHL,ATL,15931,3924,44,445,20344
PHL,AUS,141,33,0,7,181
PHL,BDL,827,171,1,16,1015
PHL,BNA,1708,362,2,27,2099
PHL,BOS,14467,3433,2,683,18585
PHL,BUF,613,130,0,15,758
PHL,BWI,1655,340,1,44,2040
PHL,CLE,1027,285,0,41,1353
PHL,CLT,8095,2105,11,181,10392
PHL,CVG,949,186,4,55,1194
PHL,DCA,1382,301,2,32,1717
PHL,DEN,7028,1732,24,118,8902
PHL,DFW,9239,1920,70,267,11496
PHL,DTW,5098,1202,5,173,6478
PHL,ELM,0,1,0,0,1
PHL,EWR,96,60,0,15,171
PHL,FLL,6410,1650,15,106,8181
PHL,GSO,3,1,0,0,4
PHL,HOU,1183,207,5,21,1416
PHL,IAH,4984,1283,20,76,6363
PHL,IND,972,295,1,20,1288
PHL,JAX,2293,537,3,35,2868
PHL,JFK,154,98,0,26,278
PHL,LAS,5153,1232,19,86,6490
PHL,LAX,5722,1652,25,67,7466
PHL,LGA,886,132,0,25,1043
PHL,MCO,13166,3145,19,236,16566
PHL,MDW,5202,1122,17,152,6493
PHL,MEM,674,145,2,52,873
PHL,MHT,2863,607,1,95,3566
PHL,MIA,5156,1370,12,135,6673
PHL,MSP,4478,961,8,130,5577
PHL,MSY,1445,388,1,23,1857
PHL,ORD,15377,4103,46,687,20213
PHL,ORF,6,0,0,0,6
PHL,PBI,3805,938,13,91,4847
PHL,PDX,347,132,1,6,486
PHL,PHX,6349,1479,18,113,7959
PHL,PIT,5322,1293,4,143,6762
PHL,PVD,4467,831,3,153,5454
PHL,PWM,177,22,0,2,201
PHL,RDU,6649,1540,14,130,8333
PHL,RSW,2991,687,6,47,3731
PHL,SAN,1952,574,18,43,2587
PHL,SAT,79,38,0,2,119
PHL,SEA,2273,638,11,38,2960
PHL,SFO,5647,1880,56,108,7691
PHL,SJU,3047,988,11,40,4086
PHL,SLC,1213,221,3,22,1459
PHL,SMF,321,128,2,9,460
PHL,STL,1812,403,6,37,2258
PHL,STT,425,153,4,4,586
PHL,SYR,410,75,0,6,491
PHL,TPA,7015,1634,16,134,8799
PHX,ABQ,11996,2063,17,79,14155
PHX,ANC,918,247,23,0,1188
PHX,ATL,10344,1661,42,57,12104
PHX,AUS,7060,1428,8,23,8519
PHX,BFL,2883,331,8,20,3242
PHX,BHM,695,233,3,2,933
PHX,BKG,8,0,0,0,8
PHX,BNA,2055,460,8,3,2526
PHX,BOI,2467,429,3,5,2904
PHX,BOS,3934,1005,7,45,4991
PHX,BUF,873,217,0,2,1092
PHX,BUR,10728,1813,20,108,12669
PHX,BWI,4557,1000,23,55,5635
PHX,CLE,1474,175,5,7,1661
PHX,CLT,6990,1343,17,38,8388
PHX,CMH,2935,508,8,3,3454
PHX,COS,176,49,0,1,226
PHX,CVG,818,88,0,5,911
PHX,DCA,2559,658,11,34,3262
PHX,DEN,20476,3712,34,131,24353
PHX,DFW,12701,2144,64,163,15072
PHX,DRO,2109,207,9,15,2340
PHX,DSM,1898,285,9,10,2202
PHX,DTW,7823,1258,28,17,9126
PHX,ELP,9738,1771,14,58,11581
PHX,EWR,6147,2070,35,120,8372
PHX,FAT,4354,493,8,35,4890
PHX,FLG,5784,578,7,206,6575
PHX,FLL,2109,459,12,6,2586
PHX,GEG,2437,351,11,3,2802
PHX,GJT,2698,370,4,16,3088
PHX,HNL,2782,485,10,7,3284
PHX,HOU,3227,911,14,17,4169
PHX,IAD,975,145,1,14,1135
PHX,IAH,9333,1360,40,43,10776
PHX,IND,3237,794,9,16,4056
PHX,JFK,4895,1181,30,93,6199
PHX,KOA,858,122,4,1,985
PHX,LAS,21822,3399,15,303,25539
PHX,LAX,22425,4582,15,369,27391
PHX,LGA,23,3,0,0,26
PHX,LGB,4342,472,11,32,4857
PHX,LIH,810,144,6,0,960
PHX,LIT,791,297,6,2,1096
PHX,MCI,5528,896,17,20,6461
PHX,MCO,2962,561,6,0,3529
PHX,MDW,5779,1362,28,80,7249
PHX,MEM,1810,244,5,16,2075
PHX,MHT,424,177,1,4,606
PHX,MIA,993,133,8,9,1143
PHX,MKE,4631,996,14,18,5659
PHX,MRY,2259,316,22,26,2623
PHX,MSP,10385,1822,31,63,12301
PHX,MSY,831,257,4,5,1097
PHX,OAK,9436,1763,9,73,11281
PHX,OGG,1407,275,9,6,1697
PHX,OKC,1629,541,2,9,2181
PHX,OMA,4267,753,11,15,5046
PHX,ONT,11004,2104,9,73,13190
PHX,ORD,11418,2582,49,139,14188
PHX,PDX,9638,1563,14,23,11238
PHX,PHL,6356,1471,14,114,7955
PHX,PIT,3180,641,7,8,3836
PHX,PSP,5216,634,13,57,5920
PHX,PVD,564,156,5,8,733
PHX,RDU,841,280,2,1,1124
PHX,RNO,6500,995,17,36,7548
PHX,SAN,16099,3318,20,186,19623
PHX,SAT,6437,1195,11,13,7656
PHX,SBA,4632,571,17,31,5251
PHX,SBP,2658,429,20,14,3121
PHX,SDF,874,217,2,0,1093
PHX,SEA,13111,1701,8,44,14864
PHX,SFO,10636,4077,16,143,14872
PHX,SJC,9620,1448,9,83,11160
PHX,SLC,16191,2638,27,103,18959
PHX,SMF,9428,1771,13,40,11252
PHX,SNA,13465,1877,16,62,15420
PHX,STL,5518,968,14,28,6528
PHX,TEX,278,21,21,23,343
PHX,TPA,2872,518,14,1,3405
PHX,TUL,1645,501,6,8,2160
PHX,TUS,9564,1017,6,81,10668
PHX,YUM,5616,549,7,135,6307
PIA,ATL,577,63,1,9,650
PIA,DEN,966,134,1,23,1124
PIA,DFW,2263,467,15,57,2802
PIA,DTW,483,144,1,21,649
PIA,MSP,407,100,3,15,525
PIA,ORD,3533,757,7,217,4514
PIE,MKE,91,21,0,1,113
PIH,SLC,3290,337,5,48,3680
PIT,ATL,10551,1690,24,177,12442
PIT,BOS,2128,526,2,48,2704
PIT,BWI,2679,575,9,40,3303
PIT,CLE,54,19,1,1,75
PIT,CLT,7021,894,8,52,7975
PIT,CRW,0,1,1,0,2
PIT,CVG,1021,146,3,33,1203
PIT,DEN,2011,411,16,17,2455
PIT,DFW,3227,628,11,62,3928
PIT,DTW,1970,580,3,62,2615
PIT,EWR,1322,517,2,141,1982
PIT,FLL,1525,244,3,16,1788
PIT,IAD,1654,452,3,58,2167
PIT,IAH,3965,971,26,43,5005
PIT,JFK,3659,1016,1,203,4879
PIT,LAS,1983,304,8,11,2306
PIT,LAX,751,162,5,6,924
PIT,LGA,205,57,1,22,285
PIT,LIT,1,1,1,0,3
PIT,MCO,4797,763,5,27,5592
PIT,MDW,4617,967,23,43,5650
PIT,MEM,1070,220,5,23,1318
PIT,MIA,1443,386,16,25,1870
PIT,MKE,1357,314,1,42,1714
PIT,MSP,1618,331,6,33,1988
PIT,ORD,7936,1697,16,244,9893
PIT,PHL,5982,1654,27,160,7823
PIT,PHX,3342,471,10,12,3835
PIT,RSW,1289,176,8,9,1482
PIT,SFO,945,129,3,12,1089
PIT,TPA,2339,351,10,12,2712
PLN,DCA,1,0,0,0,1
PLN,DTW,301,61,3,19,384
PNS,ATL,9588,1769,15,138,11510
PNS,CLT,1711,167,0,23,1901
PNS,DFW,4781,1076,35,121,6013
PNS,IAD,1380,147,9,41,1577
PNS,IAH,3822,790,17,72,4701
PNS,MEM,1835,248,8,40,2131
PNS,MIA,1984,358,15,46,2403
PNS,ORD,386,249,4,20,659
PNS,VPS,0,1,0,0,1
PSC,DEN,2659,369,13,43,3084
PSC,GEG,0,0,0,1,1
PSC,MSP,367,41,1,5,414
PSC,SFO,1702,371,8,44,2125
PSC,SLC,4028,236,7,38,4309
PSE,JFK,909,159,3,34,1105
PSE,MCO,1098,192,2,16,1308
PSG,JNU,867,182,16,20,1085
PSG,WRG,884,166,12,26,1088
PSP,DEN,2870,594,17,32,3513
PSP,DFW,2271,373,10,31,2685
PSP,EUG,1,0,0,0,1
PSP,FAT,0,1,0,0,1
PSP,IAH,317,84,2,3,406
PSP,JFK,0,2,0,0,2
PSP,LAS,2385,555,2,67,3009
PSP,LAX,5163,1132,9,60,6364
PSP,LGB,0,0,0,1,1
PSP,MSP,86,17,0,1,104
PSP,ONT,1,0,0,0,1
PSP,ORD,824,230,6,15,1075
PSP,PDX,518,47,2,2,569
PSP,PHX,5245,583,3,90,5921
PSP,SEA,1650,261,1,8,1920
PSP,SFO,4377,1595,18,124,6114
PSP,SLC,2133,191,5,23,2352
PVD,ATL,2678,453,11,60,3202
PVD,BNA,392,52,0,2,446
PVD,BWI,7688,1555,24,170,9437
PVD,CLE,1392,194,3,18,1607
PVD,CLT,4234,733,9,78,5054
PVD,DCA,794,50,3,21,868
PVD,DEN,340,17,0,2,359
PVD,DTW,1625,322,3,52,2002
PVD,EWR,1952,699,3,146,2800
PVD,FLL,1522,214,4,17,1757
PVD,IAD,1639,261,2,55,1957
PVD,IND,2,0,0,0,2
PVD,LAS,989,89,4,9,1091
PVD,MCO,4405,633,9,51,5098
PVD,MDW,2931,334,9,46,3320
PVD,MSP,124,8,1,4,137
PVD,ORD,1846,323,4,71,2244
PVD,PHL,4263,969,17,166,5415
PVD,PHX,603,119,5,5,732
PVD,RDU,36,4,0,3,43
PVD,RSW,64,6,0,0,70
PVD,TPA,2023,305,7,21,2356
PWM,ATL,2102,467,10,37,2616
PWM,BWI,2479,330,6,47,2862
PWM,CLE,402,64,1,8,475
PWM,CLT,942,157,0,22,1121
PWM,DTW,963,237,2,35,1237
PWM,EWR,860,448,2,86,1396
PWM,IAD,1336,288,6,62,1692
PWM,JFK,3203,697,4,139,4043
PWM,LGA,546,163,0,49,758
PWM,MCO,433,95,0,6,534
PWM,ORD,1778,385,12,83,2258
PWM,PHL,177,27,0,3,207
RAP,DEN,5780,1021,6,197,7004
RAP,DFW,930,183,7,26,1146
RAP,IAH,51,30,1,0,82
RAP,MSP,3715,679,6,85,4485
RAP,ORD,1574,425,3,62,2064
RAP,SLC,1650,203,2,26,1881
RDD,ACV,0,0,9,0,9
RDD,CEC,0,0,1,0,1
RDD,SFO,3371,1088,5,224,4688
RDD,SMF,2,0,0,0,2
RDM,DEN,948,197,5,9,1159
RDM,MFR,1,0,0,0,1
RDM,ONT,1,0,0,0,1
RDM,PDX,3114,315,2,40,3471
RDM,PSP,0,0,1,0,1
RDM,SFO,2146,633,9,63,2851
RDM,SLC,1902,136,2,18,2058
RDU,ATL,13759,2141,11,205,16116
RDU,BDL,353,75,2,19,449
RDU,BNA,3478,574,3,16,4071
RDU,BOS,5263,1313,15,148,6739
RDU,BWI,5704,1237,16,90,7047
RDU,CLE,920,133,1,11,1065
RDU,CLT,7367,1455,6,76,8904
RDU,CMH,191,30,3,4,228
RDU,CVG,896,103,0,14,1013
RDU,DCA,6011,988,8,435,7442
RDU,DEN,996,125,8,6,1135
RDU,DFW,4456,694,29,91,5270
RDU,DTW,2574,420,4,54,3052
RDU,EWN,1,0,0,0,1
RDU,EWR,1790,909,7,123,2829
RDU,FLL,1888,275,2,12,2177
RDU,HOU,203,51,0,0,254
RDU,IAD,3764,564,3,108,4439
RDU,IAH,4135,961,17,38,5151
RDU,IND,398,99,1,11,509
RDU,JFK,6615,1662,27,337,8641
RDU,LAS,958,133,3,2,1096
RDU,LAX,217,123,0,1,341
RDU,LGA,8183,2043,29,572,10827
RDU,MCO,3639,558,6,36,4239
RDU,MDW,3000,430,10,26,3466
RDU,MEM,1515,330,12,44,1901
RDU,MIA,2717,510,8,37,3272
RDU,MSP,995,170,3,13,1181
RDU,ORD,6813,1427,32,177,8449
RDU,PHL,6290,1858,20,165,8333
RDU,PHX,942,175,5,1,1123
RDU,ROA,0,0,1,0,1
RDU,RSW,2,3,0,0,5
RDU,SFO,88,49,0,1,138
RDU,STL,955,198,4,11,1168
RDU,TPA,2962,496,6,22,3486
RDU,TYS,0,1,0,0,1
RDU,XNA,0,1,0,0,1
RFD,DEN,41,18,0,1,60
RIC,ATL,10649,1495,22,211,12377
RIC,BOS,1652,397,1,37,2087
RIC,BWI,0,0,1,0,1
RIC,CLE,1928,624,0,36,2588
RIC,CLT,4521,582,7,58,5168
RIC,CVG,379,38,2,21,440
RIC,DFW,2599,413,20,63,3095
RIC,DTW,698,202,2,37,939
RIC,EWR,3614,1200,9,169,4992
RIC,FLL,894,173,6,9,1082
RIC,IAD,1503,371,3,48,1925
RIC,IAH,1979,609,22,20,2630
RIC,JFK,960,289,1,79,1329
RIC,LGA,156,82,0,11,249
RIC,MCO,1824,290,2,14,2130
RIC,MIA,1188,173,9,24,1394
RIC,MSP,70,5,0,0,75
RIC,ORD,5936,1297,28,214,7475
RIC,PHL,1,0,0,0,1
RIC,ROA,0,0,0,1,1
RKS,DEN,2236,421,5,79,2741
RKS,GCC,896,185,0,16,1097
RKS,SLC,1794,332,1,65,2192
RNO,ATL,0,2,0,0,2
RNO,BOI,1217,293,3,3,1516
RNO,DEN,4496,580,9,33,5118
RNO,DFW,2304,376,28,38,2746
RNO,IAH,313,66,4,3,386
RNO,LAS,9273,1519,3,44,10839
RNO,LAX,6695,1229,2,44,7970
RNO,MDW,990,92,5,6,1093
RNO,MFR,1,0,0,0,1
RNO,MSP,294,34,2,3,333
RNO,OAK,2471,393,0,14,2878
RNO,ORD,861,204,6,21,1092
RNO,PDX,2192,411,2,8,2613
RNO,PHX,6737,718,10,68,7533
RNO,SAN,1841,312,2,17,2172
RNO,SEA,1085,210,0,6,1301
RNO,SFO,3804,1422,3,179,5408
RNO,SJC,1836,311,7,13,2167
RNO,SLC,5357,519,3,48,5927
ROA,ATL,3835,982,11,133,4961
ROA,CRW,1,0,0,0,1
ROA,DTW,787,156,2,29,974
ROA,IAD,1380,282,0,103,1765
ROA,LWB,178,28,2,12,220
ROA,MIA,0,1,0,0,1
ROA,ORD,1510,451,12,98,2071
ROC,ATL,5560,1009,13,78,6660
ROC,BWI,2357,280,4,30,2671
ROC,CLE,934,193,2,20,1149
ROC,CLT,1032,171,0,15,1218
ROC,CVG,100,5,0,1,106
ROC,DTW,801,245,0,26,1072
ROC,EWR,1239,599,2,132,1972
ROC,IAD,1852,414,6,68,2340
ROC,JFK,4124,891,9,179,5203
ROC,LGA,42,11,0,4,57
ROC,MCO,1219,228,2,3,1452
ROC,MSP,42,17,0,3,62
ROC,ORD,6692,1685,10,243,8630
ROC,RSW,52,4,0,0,56
ROC,TPA,889,99,6,3,997
ROW,DFW,2727,460,11,69,3267
ROW,LAX,189,12,0,0,201
ROW,SLC,0,2,0,0,2
RST,DTW,247,46,1,14,308
RST,MSP,2299,204,0,94,2597
RST,ORD,2040,556,4,146,2746
RSW,ATL,10661,1580,13,100,12354
RSW,BDL,270,53,0,3,326
RSW,BMI,37,6,0,0,43
RSW,BNA,138,32,0,0,170
RSW,BOS,3910,1005,8,68,4991
RSW,BUF,490,120,1,7,618
RSW,BWI,3253,561,11,32,3857
RSW,CAK,420,77,1,3,501
RSW,CLE,1349,154,1,6,1510
RSW,CLT,4731,598,8,36,5373
RSW,CMH,1345,176,4,6,1531
RSW,CVG,1237,122,3,16,1378
RSW,DCA,1523,197,5,26,1751
RSW,DEN,385,77,1,1,464
RSW,DFW,2125,367,10,28,2530
RSW,DTW,3289,462,5,21,3777
RSW,EWR,3251,1121,20,84,4476
RSW,FLL,1,0,0,0,1
RSW,FNT,392,51,3,0,446
RSW,GRR,287,54,2,2,345
RSW,HPN,1291,313,10,30,1644
RSW,IAH,2229,435,6,21,2691
RSW,IND,2280,283,5,12,2580
RSW,ISP,150,36,3,2,191
RSW,JFK,3210,807,13,91,4121
RSW,LGA,1382,335,10,52,1779
RSW,MCI,6,0,0,0,6
RSW,MCO,3438,437,2,11,3888
RSW,MDW,3878,578,21,32,4509
RSW,MEM,55,9,0,1,65
RSW,MIA,280,58,1,13,352
RSW,MKE,1736,288,3,13,2040
RSW,MLI,43,0,1,0,44
RSW,MSP,2138,357,8,24,2527
RSW,ORD,1878,440,5,31,2354
RSW,PHL,3079,599,6,49,3733
RSW,PIT,1301,177,7,5,1490
RSW,PVD,67,3,0,0,70
RSW,RDU,2,2,0,1,5
RSW,ROC,51,3,0,2,56
RSW,STL,982,174,3,3,1162
SAF,DFW,2258,484,14,60,2816
SAF,LAX,937,146,0,12,1095
SAN,ABQ,2159,431,6,10,2606
SAN,ATL,5106,652,16,47,5821
SAN,AUS,1799,299,7,2,2107
SAN,BNA,1202,176,5,2,1385
SAN,BOS,1248,287,2,25,1562
SAN,BWI,1774,341,6,24,2145
SAN,CLE,39,12,1,0,52
SAN,CLT,1605,259,3,27,1894
SAN,COS,31,21,0,0,52
SAN,CVG,492,61,2,5,560
SAN,DCA,142,53,1,5,201
SAN,DEN,12576,2044,22,96,14738
SAN,DFW,7902,1500,46,119,9567
SAN,DTW,2009,222,7,8,2246
SAN,ELP,947,142,1,2,1092
SAN,EUG,1,0,0,0,1
SAN,EWR,2628,738,22,60,3448
SAN,HNL,1249,302,0,2,1553
SAN,HOU,1777,365,5,4,2151
SAN,IAD,2877,438,14,46,3375
SAN,IAH,5980,660,23,22,6685
SAN,JFK,4201,765,31,101,5098
SAN,LAS,10159,2182,3,128,12472
SAN,LAX,27758,4008,9,591,32366
SAN,MCI,1553,288,4,5,1850
SAN,MCO,58,0,0,2,60
SAN,MDW,3356,590,12,32,3990
SAN,MEM,79,13,1,0,93
SAN,MKE,303,52,0,2,357
SAN,MMH,115,5,1,15,136
SAN,MSP,3174,323,4,25,3526
SAN,OAK,9879,2332,4,269,12484
SAN,OGG,859,118,2,0,979
SAN,ORD,6917,1331,33,97,8378
SAN,PDX,3040,262,1,14,3317
SAN,PHL,2106,429,16,40,2591
SAN,PHX,16806,2633,7,226,19672
SAN,RNO,1821,290,6,16,2133
SAN,SAT,1776,277,4,7,2064
SAN,SEA,6903,540,4,37,7484
SAN,SFO,13845,5195,18,449,19507
SAN,SJC,8027,1746,5,102,9880
SAN,SLC,4667,578,5,32,5282
SAN,SMF,9070,1939,4,153,11166
SAN,STL,701,81,2,7,791
SAN,TUS,2627,610,4,20,3261
SAT,ATL,9731,1652,24,129,11536
SAT,BNA,1764,250,4,2,2020
SAT,BWI,2318,324,11,20,2673
SAT,CLT,2659,293,9,18,2979
SAT,CVG,93,26,0,7,126
SAT,DAL,11594,1915,33,159,13701
SAT,DEN,5115,844,12,26,5997
SAT,DFW,13499,2125,27,280,15931
SAT,DTW,1230,140,4,15,1389
SAT,ELP,2498,534,3,8,3043
SAT,EWR,1240,449,10,35,1734
SAT,HOU,4336,919,8,26,5289
SAT,HRL,1558,271,3,11,1843
SAT,IAD,904,255,10,9,1178
SAT,IAH,8670,1173,6,65,9914
SAT,JFK,576,151,0,11,738
SAT,LAS,3743,566,5,3,4317
SAT,LAX,4186,816,10,21,5033
SAT,MCO,1574,285,7,3,1869
SAT,MDW,1766,318,6,13,2103
SAT,MEM,1988,306,3,36,2333
SAT,MSP,738,97,0,7,842
SAT,ORD,3154,892,11,69,4126
SAT,PHL,102,13,1,2,118
SAT,PHX,6749,890,10,31,7680
SAT,SAN,1750,284,9,4,2047
SAT,SEA,100,6,0,0,106
SAT,SFO,1321,297,4,16,1638
SAT,SLC,2029,180,4,9,2222
SAT,STL,224,38,1,1,264
SAT,TPA,948,135,3,1,1087
SAV,ATL,8601,1905,9,162,10677
SAV,CLT,2940,333,5,34,3312
SAV,DFW,2430,467,23,40,2960
SAV,DTW,553,128,2,15,698
SAV,EWR,1999,838,13,174,3024
SAV,IAD,2413,534,12,91,3050
SAV,IAH,1750,584,10,27,2371
SAV,LGA,341,113,4,50,508
SAV,MIA,126,49,0,7,182
SAV,ORD,2266,678,16,104,3064
SAV,TYS,0,1,0,0,1
SBA,DEN,2094,288,12,35,2429
SBA,FAT,2,0,0,0,2
SBA,LAX,11710,1886,5,200,13801
SBA,MRY,1,0,0,0,1
SBA,PDX,81,2,0,0,83
SBA,PHX,4771,426,7,48,5252
SBA,SBP,1,1,0,0,2
SBA,SEA,534,57,0,7,598
SBA,SFO,5248,3089,23,372,8732
SBA,SJC,596,46,0,11,653
SBA,SLC,450,20,1,1,472
SBN,ATL,1424,296,7,27,1754
SBN,CVG,500,86,1,9,596
SBN,DEN,33,15,0,0,48
SBN,DTW,1532,389,0,47,1968
SBN,EWR,6,3,0,0,9
SBN,MSP,739,104,1,13,857
SBN,ORD,4151,1119,2,334,5606
SBP,BFL,0,1,0,0,1
SBP,LAX,4883,1020,5,97,6005
SBP,MFR,1,0,0,0,1
SBP,PHX,2782,299,4,36,3121
SBP,SFO,3474,1567,9,281,5331
SCC,ANC,582,68,1,13,664
SCC,BRW,1140,196,35,24,1395
SCE,ATL,1,0,0,0,1
SCE,DTW,775,177,3,25,980
SDF,ATL,6382,1502,14,160,8058
SDF,BHM,1003,181,1,2,1187
SDF,BNA,0,0,0,1,1
SDF,BOS,0,2,0,0,2
SDF,BWI,3218,490,9,45,3762
SDF,CLE,1689,322,1,15,2027
SDF,CLT,2298,287,1,46,2632
SDF,CVG,359,91,0,5,455
SDF,DEN,1371,410,21,11,1813
SDF,DFW,3484,636,20,79,4219
SDF,DTW,656,138,0,11,805
SDF,EWR,1772,898,11,157,2838
SDF,IAD,481,159,2,3,645
SDF,IAH,2444,568,7,20,3039
SDF,IND,0,0,1,0,1
SDF,LAS,977,119,0,0,1096
SDF,LGA,1,3,0,1,5
SDF,MCO,1001,126,1,0,1128
SDF,MDW,4015,713,6,41,4775
SDF,MEM,639,83,2,11,735
SDF,MIA,1132,260,5,18,1415
SDF,MSP,616,339,3,26,984
SDF,ORD,2802,675,4,89,3570
SDF,PHX,987,102,1,2,1092
SDF,STL,1635,338,4,6,1983
SDF,TPA,1045,113,1,0,1159
SEA,ABQ,1767,221,5,4,1997
SEA,ANC,15293,2596,24,86,17999
SEA,ATL,7153,1185,27,34,8399
SEA,AUS,926,151,1,1,1079
SEA,BDL,1,0,0,0,1
SEA,BNA,434,54,2,0,490
SEA,BOI,1181,201,1,2,1385
SEA,BOS,2449,542,2,22,3015
SEA,BUR,2979,207,3,6,3195
SEA,BWI,743,171,3,3,920
SEA,CLE,384,78,3,0,465
SEA,CLT,1616,484,8,17,2125
SEA,COS,68,20,0,0,88
SEA,CVG,884,85,2,4,975
SEA,DCA,1872,279,9,19,2179
SEA,DEN,14905,2051,34,80,17070
SEA,DFW,9327,1647,72,93,11139
SEA,DTW,3352,469,10,11,3842
SEA,EWR,4628,1213,18,72,5931
SEA,FAI,2812,446,7,3,3268
SEA,FAT,516,78,2,2,598
SEA,FLL,160,9,0,0,169
SEA,GEG,5381,665,10,66,6122
SEA,HNL,3846,868,24,3,4741
SEA,HOU,62,8,0,0,70
SEA,IAD,2840,390,6,36,3272
SEA,IAH,6538,1201,24,31,7794
SEA,JFK,4832,833,33,89,5787
SEA,JNU,3096,421,31,21,3569
SEA,KOA,1036,206,10,0,1252
SEA,KTN,3358,447,28,21,3854
SEA,LAS,11275,1295,15,22,12607
SEA,LAX,14444,1905,6,49,16404
SEA,LGB,4126,589,10,30,4755
SEA,LIH,933,172,16,0,1121
SEA,MCI,987,123,1,1,1112
SEA,MCO,1508,155,2,1,1666
SEA,MDW,2599,305,11,15,2930
SEA,MEM,657,87,2,9,755
SEA,MIA,926,194,6,2,1128
SEA,MKE,1238,131,4,5,1378
SEA,MSP,7488,861,15,31,8395
SEA,MWH,262,7,0,2,271
SEA,OAK,9686,1333,3,50,11072
SEA,OGG,2382,433,14,0,2829
SEA,ONT,2790,318,4,9,3121
SEA,ORD,11219,2128,39,132,13518
SEA,PDX,8716,658,3,124,9501
SEA,PHL,2425,483,11,39,2958
SEA,PHX,13257,1473,21,86,14837
SEA,PSP,1728,182,3,8,1921
SEA,RNO,1153,135,2,6,1296
SEA,SAN,6712,731,22,18,7483
SEA,SAT,101,5,0,0,106
SEA,SBA,541,54,0,3,598
SEA,SFO,12408,4019,44,147,16618
SEA,SIT,260,25,2,1,288
SEA,SJC,7074,897,2,20,7993
SEA,SLC,8553,1300,5,50,9908
SEA,SMF,7636,1031,6,20,8693
SEA,SNA,7307,440,13,30,7790
SEA,STL,1649,254,7,9,1919
SEA,TUS,1020,112,4,2,1138
SFO,ABQ,858,443,3,9,1313
SFO,ACV,4446,2336,67,397,7246
SFO,ANC,249,82,0,0,331
SFO,ASE,287,168,21,20,496
SFO,ATL,8056,1580,36,48,9720
SFO,AUS,2911,987,3,36,3937
SFO,BFL,2111,950,12,91,3164
SFO,BOI,3401,1258,10,79,4748
SFO,BOS,7508,2358,16,121,10003
SFO,BUR,4246,1442,10,268,5966
SFO,BWI,983,404,2,16,1405
SFO,BZN,611,110,2,9,732
SFO,CEC,1071,861,48,106,2086
SFO,CIC,2778,1104,6,197,4085
SFO,CLE,1321,455,3,8,1787
SFO,CLT,3729,1015,8,26,4778
SFO,COS,704,377,8,11,1100
SFO,CVG,1221,248,4,8,1481
SFO,DCA,267,97,4,4,372
SFO,DEN,14156,3713,23,124,18016
SFO,DFW,11306,3144,77,236,14763
SFO,DTW,3328,601,10,17,3956
SFO,EUG,4857,1717,16,219,6809
SFO,EWR,6503,2552,39,168,9262
SFO,FAT,2782,1886,2,61,4731
SFO,FLL,1350,481,3,11,1845
SFO,GEG,1666,721,7,67,2461
SFO,GJT,1,0,1,0,2
SFO,HNL,5174,1700,9,47,6930
SFO,IAD,7847,2150,25,140,10162
SFO,IAH,6697,2147,19,38,8901
SFO,IDA,365,109,2,8,484
SFO,IND,3,0,0,0,3
SFO,ITO,33,29,0,0,62
SFO,JAC,58,8,0,4,70
SFO,JFK,17481,4042,95,435,22053
SFO,KOA,1558,353,1,5,1917
SFO,LAS,16600,4390,16,178,21184
SFO,LAX,32114,10246,18,1069,43447
SFO,LGB,3194,748,7,40,3989
SFO,LIH,971,213,6,0,1190
SFO,LMT,1381,472,15,46,1914
SFO,MCI,1319,480,8,18,1825
SFO,MCO,1410,421,5,3,1839
SFO,MDW,2203,652,21,22,2898
SFO,MEM,236,24,0,3,263
SFO,MFR,4346,2092,12,279,6729
SFO,MIA,2426,786,21,55,3288
SFO,MKE,1329,355,3,10,1697
SFO,MMH,209,69,1,66,345
SFO,MOD,2664,1377,2,389,4432
SFO,MRY,4079,1828,11,520,6438
SFO,MSO,326,72,0,6,404
SFO,MSP,5875,1036,16,51,6978
SFO,MSY,490,184,1,8,683
SFO,OGG,2066,482,9,16,2573
SFO,OKC,366,118,2,3,489
SFO,OMA,1,0,0,0,1
SFO,ONT,3125,1079,4,163,4371
SFO,ORD,16174,4696,52,330,21252
SFO,OTH,1417,938,31,66,2452
SFO,PDX,6852,1948,6,75,8881
SFO,PHL,6259,1606,17,112,7994
SFO,PHX,12065,2612,9,196,14882
SFO,PIT,818,260,1,11,1090
SFO,PSC,1672,398,6,52,2128
SFO,PSP,4366,1623,15,110,6114
SFO,RDD,3034,1447,6,200,4687
SFO,RDM,2041,761,8,44,2854
SFO,RDU,77,60,0,1,138
SFO,RNO,4352,1341,10,181,5884
SFO,SAN,14282,4115,43,381,18821
SFO,SAT,1077,554,1,6,1638
SFO,SBA,5650,2676,28,365,8719
SFO,SBP,3584,1498,12,249,5343
SFO,SEA,12728,3225,5,103,16061
SFO,SLC,7240,2411,13,165,9829
SFO,SMF,4761,2415,5,468,7649
SFO,SNA,10358,2720,30,447,13555
SFO,STL,761,370,3,8,1142
SFO,TUS,1280,460,1,26,1767
SGF,ATL,3254,607,7,52,3920
SGF,DEN,1848,376,11,46,2281
SGF,DFW,6691,1181,22,193,8087
SGF,DTW,65,17,0,1,83
SGF,MCI,1,0,0,0,1
SGF,MEM,1755,231,4,50,2040
SGF,MSP,58,9,0,1,68
SGF,ORD,4871,1138,9,228,6246
SGF,XNA,0,0,0,1,1
SGU,LAX,394,170,1,6,571
SGU,SLC,5124,582,7,51,5764
SHD,MCO,16,2,0,0,18
SHV,ATL,4380,799,16,118,5313
SHV,BKG,37,8,0,0,45
SHV,DEN,107,18,0,0,125
SHV,DFW,3514,496,3,131,4144
SHV,GJT,0,1,0,0,1
SHV,IAH,2568,352,9,50,2979
SHV,MEM,2406,318,0,68,2792
SHV,MLU,0,1,0,0,1
SHV,ORD,1,1,1,0,3
SHV,XNA,1,1,1,0,3
SIT,ANC,1,1,0,0,2
SIT,JNU,1828,281,39,25,2173
SIT,KTN,918,149,10,14,1091
SIT,SEA,495,48,1,9,553
SJC,ATL,832,147,2,10,991
SJC,AUS,1956,263,3,2,2224
SJC,BOS,593,148,2,9,752
SJC,BUR,7112,1020,8,220,8360
SJC,DEN,7077,1014,18,66,8175
SJC,DFW,4750,869,34,71,5724
SJC,HNL,1115,168,2,0,1285
SJC,IAH,2336,249,15,4,2604
SJC,JFK,788,223,6,23,1040
SJC,KOA,481,29,0,1,511
SJC,LAS,7700,1165,1,55,8921
SJC,LAX,16289,2886,13,271,19459
SJC,LGB,10,2,0,0,12
SJC,LIH,406,40,0,0,446
SJC,MDW,985,107,3,6,1101
SJC,MRY,0,0,1,3,4
SJC,MSP,1607,212,3,12,1834
SJC,OGG,912,74,0,0,986
SJC,ONT,4466,784,4,62,5316
SJC,ORD,1698,355,5,30,2088
SJC,PDX,5009,805,5,24,5843
SJC,PHX,9834,1180,7,127,11148
SJC,RNO,1825,321,4,11,2161
SJC,SAN,8261,1496,27,128,9912
SJC,SBA,588,51,1,13,653
SJC,SEA,7079,807,7,31,7924
SJC,SLC,3907,404,3,21,4335
SJC,SNA,6860,801,7,67,7735
SJT,DFW,1367,239,0,38,1644
SJU,ATL,5923,824,34,36,6817
SJU,BDL,887,282,4,11,1184
SJU,BOS,2529,951,12,47,3539
SJU,BWI,1679,240,5,21,1945
SJU,CLE,105,16,1,0,122
SJU,CLT,2059,495,13,26,2593
SJU,DCA,101,27,1,2,131
SJU,DFW,1887,268,12,11,2178
SJU,DTW,84,24,0,1,109
SJU,EWR,2040,449,12,36,2537
SJU,FLL,3142,897,9,24,4072
SJU,IAD,1481,350,8,32,1871
SJU,IAH,1048,333,6,6,1393
SJU,JAX,466,111,4,1,582
SJU,JFK,9130,2824,37,213,12204
SJU,LAX,189,76,2,0,267
SJU,MCO,7239,1879,16,33,9167
SJU,MEM,20,8,0,0,28
SJU,MIA,6459,1720,31,77,8287
SJU,MSP,55,16,3,0,74
SJU,ORD,1905,337,18,16,2276
SJU,PBI,204,24,0,3,231
SJU,PHL,3118,889,13,66,4086
SJU,STT,653,117,0,2,772
SJU,STX,305,81,0,0,386
SJU,TPA,2175,526,4,8,2713
SLC,ABQ,4787,559,9,16,5371
SLC,ANC,1137,205,2,2,1346
SLC,ASE,70,21,5,4,100
SLC,ATL,7212,1238,28,49,8527
SLC,AUS,1395,221,0,2,1618
SLC,BIL,4282,372,13,12,4679
SLC,BIS,329,36,1,2,368
SLC,BNA,902,172,6,9,1089
SLC,BOI,5902,960,9,40,6911
SLC,BOS,1169,300,2,15,1486
SLC,BTM,1960,164,22,59,2205
SLC,BUR,2879,287,5,8,3179
SLC,BWI,2659,378,13,29,3079
SLC,BZN,4274,436,17,12,4739
SLC,CDC,1682,235,4,17,1938
SLC,CLT,427,96,1,4,528
SLC,COD,1662,178,16,20,1876
SLC,COS,2118,238,7,8,2371
SLC,CPR,2073,177,8,14,2272
SLC,CVG,2126,299,7,18,2450
SLC,DCA,1114,138,7,16,1275
SLC,DEN,20242,3982,40,127,24391
SLC,DFW,7545,1251,52,104,8952
SLC,DHN,4,0,0,0,4
SLC,DTW,3768,552,7,20,4347
SLC,EKO,3299,400,12,59,3770
SLC,ELP,60,10,0,0,70
SLC,EUG,1873,199,2,2,2076
SLC,EWR,1322,413,11,22,1768
SLC,FAI,40,13,0,0,53
SLC,FAR,1115,155,2,9,1281
SLC,FAT,2695,283,3,9,2990
SLC,FCA,3163,322,11,14,3510
SLC,FLL,74,9,0,0,83
SLC,GCC,944,148,1,3,1096
SLC,GEG,4893,707,18,30,5648
SLC,GJT,2412,211,5,16,2644
SLC,GTF,2705,267,3,5,2980
SLC,GUC,38,12,0,1,51
SLC,HDN,54,6,1,2,63
SLC,HLN,2649,286,5,7,2947
SLC,HNL,910,182,2,0,1094
SLC,IAD,1169,272,2,19,1462
SLC,IAH,5035,1100,18,30,6183
SLC,IDA,4799,511,6,53,5369
SLC,IND,929,130,3,4,1066
SLC,JAC,2955,510,7,72,3544
SLC,JFK,4507,1000,24,81,5612
SLC,LAS,12017,2139,4,35,14195
SLC,LAX,12760,2578,13,44,15395
SLC,LGA,19,1,1,0,21
SLC,LGB,6671,947,19,35,7672
SLC,LWS,1924,156,2,6,2088
SLC,MCI,1989,324,8,16,2337
SLC,MCO,1840,263,7,3,2113
SLC,MDW,1907,247,13,11,2178
SLC,MEM,1535,255,3,5,1798
SLC,MFR,1841,245,1,10,2097
SLC,MOT,226,25,1,1,253
SLC,MSO,4088,402,14,14,4518
SLC,MSP,4648,664,9,41,5362
SLC,MSY,859,225,1,6,1091
SLC,MTJ,159,15,1,1,176
SLC,OAK,7714,1206,2,39,8961
SLC,OGG,35,24,0,0,59
SLC,OKC,2170,420,6,14,2610
SLC,OMA,1685,306,2,9,2002
SLC,ONT,3885,429,7,18,4339
SLC,ORD,7163,1928,23,132,9246
SLC,PDX,6891,1201,12,22,8126
SLC,PHL,1183,254,4,20,1461
SLC,PHX,16380,2441,13,132,18966
SLC,PIH,3277,353,9,40,3679
SLC,PSC,3911,396,12,19,4338
SLC,PSP,2089,250,7,6,2352
SLC,RAP,1700,158,6,17,1881
SLC,RDM,1837,205,6,9,2057
SLC,RKS,1783,387,8,12,2190
SLC,RNO,5085,796,13,32,5926
SLC,SAN,4480,768,8,28,5284
SLC,SAT,1803,415,7,5,2230
SLC,SBA,433,39,0,0,472
SLC,SEA,8325,1525,2,38,9890
SLC,SFO,6029,2536,10,137,8712
SLC,SGU,4889,835,15,21,5760
SLC,SJC,3827,491,2,14,4334
SLC,SMF,4514,657,6,12,5189
SLC,SNA,4267,604,8,35,4914
SLC,STL,1855,425,7,19,2306
SLC,SUN,4809,587,457,130,5983
SLC,TPA,12,0,0,0,12
SLC,TUL,1046,192,1,9,1248
SLC,TUS,3086,341,8,8,3443
SLC,TWF,3405,432,6,26,3869
SLC,WYS,753,57,1,4,815
SMF,ACV,1378,345,24,106,1853
SMF,ATL,1604,309,12,11,1936
SMF,BUR,7100,999,15,142,8256
SMF,CEC,3,0,0,0,3
SMF,CIC,1,0,1,0,2
SMF,CLT,186,53,1,1,241
SMF,DEN,9647,1274,19,52,10992
SMF,DFW,3658,561,32,50,4301
SMF,DTW,128,31,1,1,161
SMF,HNL,905,187,4,0,1096
SMF,IAD,941,134,6,15,1096
SMF,IAH,2596,431,14,5,3046
SMF,JFK,627,255,2,18,902
SMF,LAS,7228,1086,4,17,8335
SMF,LAX,14348,2572,12,124,17056
SMF,LGB,2221,302,2,11,2536
SMF,MDW,1065,158,6,8,1237
SMF,MSP,1897,250,1,24,2172
SMF,OGG,975,97,6,0,1078
SMF,ONT,6852,1106,2,83,8043
SMF,ORD,1771,333,7,16,2127
SMF,PDX,5186,867,3,9,6065
SMF,PHL,369,82,6,3,460
SMF,PHX,9919,1294,11,69,11293
SMF,RNO,0,0,0,1,1
SMF,SAN,9370,1574,32,137,11113
SMF,SEA,7693,942,3,36,8674
SMF,SFO,4544,2607,4,498,7653
SMF,SLC,4680,476,5,26,5187
SMF,SNA,5758,736,8,33,6535
SMX,LAX,3540,446,1,150,4137
SNA,ATL,4377,386,20,42,4825
SNA,COS,1,0,0,0,1
SNA,DEN,10592,1488,24,79,12183
SNA,DFW,9152,1184,73,204,10613
SNA,DTW,200,15,1,4,220
SNA,EWR,2181,571,26,53,2831
SNA,HNL,321,167,1,3,492
SNA,HOU,53,4,1,0,58
SNA,IAH,4128,613,28,31,4800
SNA,JFK,62,33,1,2,98
SNA,LAS,6723,1105,6,72,7906
SNA,MDW,743,121,1,5,870
SNA,MMH,56,8,0,15,79
SNA,MSP,2719,267,11,13,3010
SNA,OAK,6438,1081,3,67,7589
SNA,OGG,245,54,2,0,301
SNA,ORD,5142,1209,56,120,6527
SNA,PDX,3759,200,1,10,3970
SNA,PHX,13672,1647,3,104,15426
SNA,RNO,0,1,0,0,1
SNA,SEA,7311,432,2,41,7786
SNA,SFO,9392,3775,12,477,13656
SNA,SJC,6553,1120,0,64,7737
SNA,SLC,4447,424,6,37,4914
SNA,SMF,5580,942,3,40,6565
SPI,DFW,1033,158,4,23,1218
SPI,ORD,3749,674,3,235,4661
SPI,STL,0,0,1,0,1
SPN,GUM,4,1,0,0,5
SPS,DFW,1393,213,0,73,1679
SRQ,ATL,7247,1157,17,72,8493
SRQ,BOS,428,128,0,11,567
SRQ,BWI,544,61,1,7,613
SRQ,CLT,1508,142,3,12,1665
SRQ,CVG,132,17,0,3,152
SRQ,DTW,224,59,1,3,287
SRQ,IND,356,50,2,5,413
SRQ,JFK,1326,335,6,41,1708
SRQ,LGA,121,97,3,3,224
SRQ,MDW,1370,177,8,10,1565
SRQ,MKE,273,76,2,3,354
SRQ,ORD,43,15,0,0,58
STL,ABE,0,0,1,0,1
STL,ABQ,887,202,0,3,1092
STL,ATL,9973,1737,21,159,11890
STL,BHM,884,204,3,5,1096
STL,BNA,1580,350,1,13,1944
STL,BOS,1888,522,6,25,2441
STL,BWI,3808,1028,14,66,4916
STL,CLE,758,260,2,10,1030
STL,CLT,3932,620,5,63,4620
STL,CMH,1480,483,1,8,1972
STL,CVG,786,94,0,11,891
STL,DAL,6686,1644,25,67,8422
STL,DCA,3747,801,22,180,4750
STL,DEN,6014,1187,24,39,7264
STL,DFW,7924,1264,22,202,9412
STL,DTW,4397,1021,9,64,5491
STL,ECP,56,14,0,0,70
STL,EWR,4097,1854,22,283,6256
STL,FLL,955,187,5,5,1152
STL,HOU,3212,683,10,20,3925
STL,IAD,126,31,0,1,158
STL,IAH,2359,564,11,33,2967
STL,JFK,685,207,9,51,952
STL,LAS,3469,573,5,15,4062
STL,LAX,4019,933,14,38,5004
STL,LGA,3377,771,20,151,4319
STL,LIT,1511,435,0,11,1957
STL,MCI,4003,842,7,26,4878
STL,MCO,4036,787,8,14,4845
STL,MDW,7788,1789,18,102,9697
STL,MEM,1588,243,2,71,1904
STL,MIA,1932,327,6,64,2329
STL,MKE,2139,423,3,66,2631
STL,MLI,0,1,0,0,1
STL,MSP,5185,1009,4,62,6260
STL,MSY,799,162,1,6,968
STL,OKC,1493,440,6,11,1950
STL,OMA,2359,602,4,14,2979
STL,ORD,8304,1868,12,333,10517
STL,PHL,1690,553,5,32,2280
STL,PHX,5637,868,18,36,6559
STL,PIA,0,1,0,1,2
STL,RDU,873,277,2,14,1166
STL,RSW,963,192,2,4,1161
STL,SAN,605,179,3,3,790
STL,SAT,225,39,0,0,264
STL,SDF,1421,533,0,6,1960
STL,SEA,1586,320,4,9,1919
STL,SFO,759,370,3,10,1142
STL,SLC,2040,340,7,23,2410
STL,TPA,1799,432,3,11,2245
STL,TUL,1524,449,6,14,1993
STT,ATL,1501,218,23,14,1756
STT,BOS,263,62,0,4,329
STT,CLT,1048,193,16,15,1272
STT,EWR,530,110,4,9,653
STT,IAD,98,13,1,1,113
STT,JFK,812,228,10,13,1063
STT,MIA,2235,403,10,29,2677
STT,ORD,32,30,3,0,65
STT,PHL,422,148,5,11,586
STT,SJU,963,141,0,8,1112
STX,ATL,77,35,13,2,127
STX,CLT,43,17,1,0,61
STX,MIA,1332,263,5,19,1619
STX,SJU,334,52,0,0,386
SUN,SLC,4840,557,8,569,5974
SUX,MSP,138,15,0,5,158
SUX,ORD,408,92,0,9,509
SWF,ATL,1092,268,4,39,1403
SWF,DTW,817,169,3,48,1037
SWF,EWR,0,1,0,0,1
SWF,FLL,819,250,4,14,1087
SWF,MCO,1137,208,1,22,1368
SYR,ATL,2409,568,10,49,3036
SYR,BOS,0,1,0,0,1
SYR,CLE,462,116,0,5,583
SYR,CLT,1911,361,1,29,2302
SYR,CVG,211,58,0,4,273
SYR,DCA,111,31,0,3,145
SYR,DTW,1139,301,1,33,1474
SYR,EWR,586,192,0,25,803
SYR,IAD,1433,245,0,50,1728
SYR,JFK,3861,1046,3,168,5078
SYR,LGA,33,17,0,7,57
SYR,MCO,1422,326,2,12,1762
SYR,MSP,65,11,1,5,82
SYR,ORD,5737,1444,21,229,7431
SYR,PHL,379,106,0,7,492
TEX,PHX,263,38,0,43,344
TLH,ATL,7421,1777,7,176,9381
TLH,CLT,32,2,0,3,37
TLH,DFW,963,265,6,21,1255
TLH,FLL,693,215,3,17,928
TLH,MEM,710,102,6,15,833
TLH,MIA,2103,577,3,69,2752
TOL,DTW,28,2,0,1,31
TOL,MSP,0,1,0,0,1
TOL,ORD,1095,240,0,51,1386
TPA,ALB,912,193,4,7,1116
TPA,ATL,18174,2897,26,187,21284
TPA,AUS,913,177,2,0,1092
TPA,AVL,156,18,1,0,175
TPA,BDL,1822,391,1,27,2241
TPA,BHM,1710,333,3,5,2051
TPA,BNA,3668,594,4,13,4279
TPA,BOS,3030,743,1,47,3821
TPA,BUF,1587,304,2,3,1896
TPA,BWI,7494,1314,27,109,8944
TPA,CAK,986,131,1,5,1123
TPA,CLE,1423,156,0,7,1586
TPA,CLT,7623,1146,6,51,8826
TPA,CMH,2186,351,1,3,2541
TPA,CVG,1482,125,0,17,1624
TPA,DAY,464,80,1,1,546
TPA,DCA,4349,702,12,82,5145
TPA,DEN,4342,628,14,14,4998
TPA,DFW,6274,1082,31,101,7488
TPA,DTW,4598,610,9,32,5249
TPA,EWR,5171,1599,27,123,6920
TPA,EYW,587,46,1,3,637
TPA,FLL,6055,1089,10,39,7193
TPA,FNT,488,65,0,0,553
TPA,GPT,159,24,1,0,184
TPA,GRR,358,28,1,1,388
TPA,HOU,3410,681,11,17,4119
TPA,HPN,886,176,5,29,1096
TPA,IAD,2865,481,10,46,3402
TPA,IAH,4593,545,18,24,5180
TPA,IND,3126,445,9,14,3594
TPA,ISP,2076,357,11,36,2480
TPA,JAX,1993,350,1,4,2348
TPA,JFK,5955,1266,19,165,7405
TPA,LAS,1751,206,2,0,1959
TPA,LAX,825,202,3,4,1034
TPA,LGA,3417,925,36,118,4496
TPA,MCI,1587,261,7,7,1862
TPA,MDW,4281,740,24,32,5077
TPA,MEM,1553,223,1,26,1803
TPA,MHT,1676,325,4,8,2013
TPA,MIA,5871,1038,11,89,7009
TPA,MKE,2006,320,6,11,2343
TPA,MSP,2355,417,7,15,2794
TPA,MSY,2660,474,4,11,3149
TPA,ORD,5212,1082,16,61,6371
TPA,ORF,959,129,4,4,1096
TPA,PBI,3146,714,5,13,3878
TPA,PHL,7103,1521,24,129,8777
TPA,PHX,2885,505,6,8,3404
TPA,PIT,2281,428,3,13,2725
TPA,PVD,2017,321,3,19,2360
TPA,RDU,2875,449,8,27,3359
TPA,ROC,843,150,4,1,998
TPA,SAT,875,200,7,0,1082
TPA,SDF,964,195,0,0,1159
TPA,SJU,2400,298,6,10,2714
TPA,SLC,8,4,0,0,12
TPA,STL,1867,366,3,8,2244
TRI,ATL,6384,1320,7,135,7846
TRI,CLT,16,1,1,1,19
TRI,CRW,0,0,0,1,1
TRI,DTW,454,45,1,10,510
TRI,ORD,883,149,3,41,1076
TRI,ROA,1,0,1,0,2
TTN,MCO,7,7,0,0,14
TUL,ATL,2994,722,10,96,3822
TUL,CID,1,0,0,0,1
TUL,CLL,0,0,1,0,1
TUL,DAL,4862,699,6,57,5624
TUL,DEN,5844,1036,18,73,6971
TUL,DFW,7531,966,13,181,8691
TUL,DTW,1504,330,3,44,1881
TUL,EWR,849,97,5,29,980
TUL,HOU,2877,429,5,22,3333
TUL,IAD,367,89,4,4,464
TUL,IAH,5869,976,11,116,6972
TUL,LAS,1021,102,1,3,1127
TUL,LAX,703,134,2,13,852
TUL,LIT,0,1,0,0,1
TUL,MEM,1755,161,4,44,1964
TUL,MIA,71,12,1,1,85
TUL,MKE,0,0,1,0,1
TUL,MSP,915,241,1,29,1186
TUL,ORD,6518,1533,20,278,8349
TUL,PHX,1887,250,1,11,2149
TUL,SLC,1046,190,1,13,1250
TUL,STL,1693,319,3,9,2024
TUL,XNA,0,0,0,1,1
TUP,MEM,1,0,0,0,1
TUS,ABQ,1792,272,2,2,2068
TUS,ASE,1,0,0,0,1
TUS,ATL,1819,294,6,13,2132
TUS,BUR,0,1,0,0,1
TUS,BWI,54,4,0,0,58
TUS,DEN,6825,963,15,48,7851
TUS,DFW,6382,849,27,98,7356
TUS,IAH,3899,611,18,34,4562
TUS,LAS,4540,675,3,10,5228
TUS,LAX,9841,1631,9,55,11536
TUS,MDW,1624,203,7,9,1843
TUS,MSP,886,157,1,6,1050
TUS,ORD,1824,326,13,21,2184
TUS,PHX,9623,916,2,127,10668
TUS,SAN,2796,501,8,7,3312
TUS,SEA,1045,91,1,2,1139
TUS,SFO,1405,339,7,18,1769
TUS,SLC,3140,285,4,15,3444
TVC,CLE,0,0,0,1,1
TVC,DEN,190,49,1,0,240
TVC,DTW,1600,368,5,56,2029
TVC,IAD,0,0,0,1,1
TVC,LGA,86,29,0,6,121
TVC,MQT,295,107,2,13,417
TVC,MSP,636,98,2,16,752
TVC,ORD,4569,1093,6,227,5895
TWF,SLC,3458,400,5,35,3898
TXK,DFW,2653,354,1,113,3121
TYR,DFW,2763,398,4,92,3257
TYR,IAH,475,63,2,16,556
TYS,ATL,6354,1571,6,162,8093
TYS,BNA,0,1,0,0,1
TYS,CLE,446,109,2,4,561
TYS,CLT,19,2,0,1,22
TYS,CVG,499,83,2,10,594
TYS,DEN,1337,200,11,7,1555
TYS,DFW,3720,760,30,102,4612
TYS,DTW,746,140,1,12,899
TYS,EWR,731,468,5,23,1227
TYS,GSP,0,2,0,0,2
TYS,IAD,2134,414,6,67,2621
TYS,IAH,2651,672,13,15,3351
TYS,LGA,352,57,2,28,439
TYS,MCO,628,72,2,3,705
TYS,MEM,1145,231,2,32,1410
TYS,MIA,860,85,2,14,961
TYS,MSP,283,60,1,6,350
TYS,ORD,6530,1465,22,281,8298
TYS,ROA,0,0,0,1,1
TYS,TRI,0,0,1,0,1
UTM,ATL,175,29,0,4,208
VLD,ATL,2536,530,3,50,3119
VPS,ATL,8055,2182,13,188,10438
VPS,CLT,25,5,0,0,30
VPS,DFW,4731,958,27,131,5847
VPS,IAH,2176,618,10,39,2843
VPS,MEM,1217,193,4,30,1444
WRG,KTN,927,126,4,31,1088
WRG,PSG,888,171,14,13,1086
WYS,SLC,781,26,1,7,815
XNA,ATL,4681,904,9,138,5732
XNA,CLT,2,0,0,0,2
XNA,CVG,538,48,1,7,594
XNA,DEN,1431,212,6,42,1691
XNA,DFW,7101,1281,20,270,8672
XNA,DTW,721,139,7,19,886
XNA,EWR,942,517,5,120,1584
XNA,IAH,2804,625,13,72,3514
XNA,LGA,1792,392,15,121,2320
XNA,MEM,1756,297,4,62,2119
XNA,MSP,1252,160,4,31,1447
XNA,ORD,7306,1996,19,376,9697
XNA,SHV,0,2,0,0,2
YAK,CDV,890,156,20,19,1085
YAK,JNU,945,97,23,19,1084
YUM,IPL,362,41,0,8,411
YUM,LAX,3520,597,9,41,4167
YUM,PHX,5658,503,0,147,6308
